Squad,Player,Rk,Nation,Pos,Comp,Age,Born,90s,Tackles_Tkl,Tackles_TklW,Tackles_Def 3rd,Tackles_Mid 3rd,Tackles_Att 3rd,Challenges_Tkl,Challenges_Att,Challenges_Tkl%,Challenges_Lost,Blocks_Blocks,Blocks_Sh,Blocks_Pass,Int,Tkl+Int,Clr,Err,PlSqu
Bournemouth,Max Aarons,1,eng ENG,DF,eng Premier League,24,2000,1.0,2,2,1,1,0,1,1,100.0,0,3,1,2,1,3,0,0,Max AaronsBournemouth
Valencia,Max Aarons,2,eng ENG,"DF,MF",es La Liga,24,2000,1.3,4,4,2,2,0,4,5,80.0,1,1,0,1,0,4,3,0,Max AaronsValencia
Valencia,Rodrigo Abajas,3,es ESP,DF,es La Liga,21,2003,0.7,3,2,2,1,0,3,3,100.0,0,1,0,1,1,4,0,0,Rodrigo AbajasValencia
Udinese,James Abankwah,4,ie IRL,"DF,MF",it Serie A,20,2004,1.0,4,2,4,0,0,2,3,66.7,1,2,1,1,1,5,3,0,James AbankwahUdinese
Marseille,Keyliane Abdallah,5,fr FRA,FW,fr Ligue 1,18,2006,0.0,1,1,1,0,0,1,1,100.0,0,0,0,0,0,1,0,0,Keyliane AbdallahMarseille
Saint-Etienne,Yunis Abdelhamid,6,ma MAR,DF,fr Ligue 1,36,1987,11.5,17,11,15,2,0,10,16,62.5,6,26,18,8,14,31,57,1,Yunis AbdelhamidSaint-Etienne
Angers,Himad Abdelli,7,dz ALG,"MF,FW",fr Ligue 1,24,1999,31.6,48,32,13,20,15,15,48,31.3,33,24,1,23,26,74,28,2,Himad AbdelliAngers
Nice,Mohamed Abdelmoneim,8,eg EGY,DF,fr Ligue 1,25,1999,9.5,21,14,12,6,3,13,22,59.1,9,11,5,6,15,36,56,1,Mohamed AbdelmoneimNice
Nice,Ali Abdi,9,tn TUN,"DF,MF",fr Ligue 1,30,1993,15.5,43,25,18,14,11,28,43,65.1,15,20,6,14,20,63,37,0,Ali AbdiNice
Roma,Saud Abdulhamid,10,sa KSA,DF,it Serie A,25,1999,2.3,3,2,2,0,1,1,1,100.0,0,2,0,2,2,5,0,0,Saud AbdulhamidRoma
Osasuna,Abel,11,es ESP,DF,es La Liga,23,2000,23.0,61,37,28,25,8,39,63,61.9,24,29,4,25,18,79,64,2,AbelOsasuna
Getafe,Nabil Aberdin,12,fr FRA,MF,es La Liga,21,2002,2.9,6,4,3,3,0,1,1,100.0,0,3,0,3,0,6,5,0,Nabil AberdinGetafe
Como,Oliver Abildgaard,13,dk DEN,MF,it Serie A,28,1996,0.1,0,0,0,0,0,0,0,,0,1,0,1,0,0,0,0,Oliver AbildgaardComo
Nantes,Matthis Abline,14,fr FRA,FW,fr Ligue 1,21,2003,30.8,11,5,2,4,5,3,9,33.3,6,15,1,14,4,15,36,1,Matthis AblineNantes
Lyon,Abner,15,br BRA,DF,fr Ligue 1,24,2000,12.1,29,20,12,10,7,21,32,65.6,11,15,2,13,5,34,41,0,AbnerLyon
Toulouse,Zakaria Aboukhlal,16,ma MAR,"MF,FW",fr Ligue 1,24,2000,21.1,22,13,7,8,7,4,23,17.4,19,16,1,15,6,28,9,0,Zakaria AboukhlalToulouse
Alaves,Abdel Abqar,17,ma MAR,DF,es La Liga,25,1999,27.4,36,23,24,11,1,20,34,58.8,14,28,18,10,39,75,146,1,Abdel AbqarAlaves
Roma,Tammy Abraham,18,eng ENG,FW,it Serie A,26,1997,0.0,0,0,0,0,0,0,1,0.0,1,0,0,0,0,0,0,0,Tammy AbrahamRoma
Milan,Tammy Abraham,19,eng ENG,FW,it Serie A,26,1997,13.1,17,11,2,10,5,6,8,75.0,2,13,0,13,2,19,16,0,Tammy AbrahamMilan
Genoa,Federico Accornero,20,it ITA,MF,it Serie A,20,2004,0.1,0,0,0,0,0,0,0,,0,0,0,0,0,0,0,0,Federico AccorneroGenoa
Inter,Francesco Acerbi,21,it ITA,DF,it Serie A,36,1988,19.0,23,19,16,7,0,11,17,64.7,6,22,16,6,26,49,81,0,Francesco AcerbiInter
Chelsea,Joshua Acheampong,22,eng ENG,DF,eng Premier League,18,2006,1.9,2,1,2,0,0,2,2,100.0,0,1,0,1,1,3,2,0,Joshua AcheampongChelsea
Sevilla,Akor Adams,23,ng NGA,FW,es La Liga,24,2000,1.5,0,0,0,0,0,0,0,,0,1,0,1,0,0,1,0,Akor AdamsSevilla
Montpellier,Akor Adams,24,ng NGA,FW,fr Ligue 1,24,2000,11.9,4,3,1,2,1,3,4,75.0,1,2,1,1,1,5,5,1,Akor AdamsMontpellier
Torino,Che Adams,25,sct SCO,FW,it Serie A,28,1996,29.5,12,6,2,4,6,1,7,14.3,6,13,6,7,2,14,18,0,Che AdamsTorino
Bournemouth,Tyler Adams,26,us USA,MF,eng Premier League,25,1999,21.8,83,50,26,49,8,39,72,54.2,33,33,10,23,32,115,42,0,Tyler AdamsBournemouth
Freiburg,Junior Adamu,27,at AUT,FW,de Bundesliga,23,2001,17.2,9,3,3,3,3,3,11,27.3,8,14,0,14,12,21,20,0,Junior AdamuFreiburg
Chelsea,Tosin Adarabioyo,28,eng ENG,DF,eng Premier League,26,1997,15.7,17,13,11,6,0,8,12,66.7,4,9,7,2,11,28,80,0,Tosin AdarabioyoChelsea
Reims,Martin Adeline,29,fr FRA,MF,fr Ligue 1,20,2003,0.3,1,1,0,1,0,1,2,50.0,1,0,0,0,0,1,2,0,Martin AdelineReims
Dortmund,Karim Adeyemi,30,de GER,"FW,MF",de Bundesliga,22,2002,15.9,20,14,6,6,8,8,20,40.0,12,14,1,13,7,27,5,0,Karim AdeyemiDortmund
Brighton,Simon Adingra,31,ci CIV,"FW,MF",eng Premier League,22,2002,12.2,23,14,10,8,5,10,26,38.5,16,12,0,12,8,31,6,2,Simon AdingraBrighton
Leverkusen,Amine Adli,32,ma MAR,"MF,FW",de Bundesliga,24,2000,8.5,15,9,4,2,9,4,11,36.4,7,11,0,11,0,15,4,0,Amine AdliLeverkusen
Fiorentina,Yacine Adli,33,fr FRA,MF,it Serie A,24,2000,13.5,32,19,11,16,5,17,39,43.6,22,13,1,12,6,38,19,0,Yacine AdliFiorentina
Betis,Adrian,34,es ESP,GK,es La Liga,37,1987,19.0,0,0,0,0,0,0,3,0.0,3,0,0,0,0,0,14,3,AdrianBetis
Lyon,Adryelson,35,br BRA,DF,fr Ligue 1,26,1998,0.0,0,0,0,0,0,0,0,,0,0,0,0,1,1,1,0,AdryelsonLyon
Juventus,Vasilije Adzic,36,me MNE,"MF,FW",it Serie A,18,2006,0.5,2,2,0,1,1,0,1,0.0,1,0,0,0,0,2,0,0,Vasilije AdzicJuventus
Bologna,Michel Aebischer,37,ch SUI,MF,it Serie A,27,1997,8.0,18,13,8,7,3,10,14,71.4,4,4,1,3,7,25,6,0,Michel AebischerBologna
St. Pauli,Oladapo Afolayan,38,eng ENG,"FW,MF",de Bundesliga,26,1998,18.2,17,8,4,8,5,7,19,36.8,12,17,1,16,8,25,20,0,Oladapo AfolayanSt. Pauli
Wolves,Emmanuel Agbadou,39,ci CIV,DF,eng Premier League,27,1997,15.7,30,19,21,9,0,13,20,65.0,7,19,13,6,12,42,90,0,Emmanuel AgbadouWolves
Reims,Emmanuel Agbadou,40,ci CIV,DF,fr Ligue 1,27,1997,14.0,25,17,19,3,3,19,26,73.1,7,22,13,9,19,44,64,1,Emmanuel AgbadouReims
Crystal Palace,Asher Agbinone,41,eng ENG,MF,eng Premier League,18,2005,0.1,2,1,0,2,0,0,0,,0,0,0,0,0,2,0,0,Asher AgbinoneCrystal Palace
Lens,Jeremy Agbonifo,42,se SWE,"FW,MF",fr Ligue 1,18,2005,3.3,7,6,6,0,1,3,7,42.9,4,2,1,1,1,8,0,1,Jeremy AgbonifoLens
Athletic Club,Julen Agirrezabala,43,es ESP,GK,es La Liga,23,2000,13.4,0,0,0,0,0,0,1,0.0,1,0,0,0,0,0,4,0,Julen AgirrezabalaAthletic Club
Sevilla,Lucien Agoume,44,fr FRA,MF,es La Liga,22,2002,23.5,70,32,23,37,10,27,39,69.2,12,30,11,19,41,111,42,0,Lucien AgoumeSevilla
Werder Bremen,Felix Agu,45,ng NGA,DF,de Bundesliga,24,1999,19.5,30,14,12,14,4,12,23,52.2,11,27,9,18,21,51,48,0,Felix AguWerder Bremen
Espanyol,Alvaro Aguado,46,es ESP,MF,es La Liga,28,1996,4.9,5,2,3,2,0,3,9,33.3,6,7,1,6,4,9,5,1,Alvaro AguadoEspanyol
Real Madrid,Lorenzo Aguado,47,es ESP,DF,es La Liga,21,2002,0.1,0,0,0,0,0,0,0,,0,0,0,0,0,0,2,0,Lorenzo AguadoReal Madrid
Real Sociedad,Nayef Aguerd,48,ma MAR,DF,es La Liga,28,1996,19.6,30,24,17,12,1,12,18,66.7,6,21,15,6,13,43,91,0,Nayef AguerdReal Sociedad
Lens,Ruben Aguilar,49,fr FRA,"DF,MF",fr Ligue 1,31,1993,12.5,34,18,17,12,5,24,39,61.5,15,25,3,22,13,47,23,0,Ruben AguilarLens
Rennes,Naouirou Ahamada,50,fr FRA,"MF,FW",fr Ligue 1,22,2002,0.6,0,0,0,0,0,0,0,,0,0,0,0,2,2,2,0,Naouirou AhamadaRennes
Genoa,Honest Ahanor,51,it ITA,"DF,MF",it Serie A,16,2008,3.0,7,5,2,3,2,7,10,70.0,3,4,0,4,1,8,9,0,Honest AhanorGenoa
St. Pauli,Erik Ahlstrand,52,se SWE,"FW,MF",de Bundesliga,22,2001,0.5,0,0,0,0,0,0,0,,0,1,0,1,1,1,1,0,Erik AhlstrandSt. Pauli
Angers,Jean-Eudes Aholou,53,ci CIV,MF,fr Ligue 1,30,1994,21.8,56,36,26,20,10,22,48,45.8,26,34,14,20,33,89,32,0,Jean-Eudes AholouAngers
Valladolid,Joseph Aidoo,54,gh GHA,DF,es La Liga,28,1995,6.5,5,5,3,2,0,2,3,66.7,1,8,4,4,5,10,26,1,Joseph AidooValladolid
Celta Vigo,Joseph Aidoo,55,gh GHA,DF,es La Liga,28,1995,0.0,1,0,1,0,0,0,0,,0,0,0,0,0,1,0,0,Joseph AidooCelta Vigo
Saint-Etienne,Ayman Aiki,56,fr FRA,"FW,MF",fr Ligue 1,19,2005,1.4,3,3,1,2,0,1,1,100.0,0,1,0,1,1,4,0,0,Ayman AikiSaint-Etienne
Nott'ham Forest,Ola Aina,57,ng NGA,DF,eng Premier League,27,1996,33.3,55,42,39,15,1,36,64,56.3,28,34,12,22,33,88,115,4,Ola AinaNott'ham Forest
Wolves,Rayan Ait-Nouri,58,dz ALG,DF,eng Premier League,23,2001,34.5,89,57,52,28,9,43,70,61.4,27,42,6,36,26,115,75,2,Rayan Ait-NouriWolves
Hellas Verona,Junior Ajayi,59,ci CIV,FW,it Serie A,19,2004,0.1,0,0,0,0,0,0,0,,0,0,0,0,0,0,0,0,Junior AjayiHellas Verona
Brentford,Kristoffer Ajer,60,no NOR,DF,eng Premier League,26,1998,16.0,26,18,14,11,1,14,27,51.9,13,17,4,13,12,38,50,0,Kristoffer AjerBrentford
Brest,Ludovic Ajorque,61,fr FRA,FW,fr Ligue 1,30,1994,27.7,26,19,3,12,11,10,32,31.3,22,20,5,15,6,32,26,0,Ludovic AjorqueBrest
Manchester City,Manuel Akanji,62,ch SUI,DF,eng Premier League,29,1995,22.4,19,12,12,4,3,11,17,64.7,6,11,8,3,9,28,64,3,Manuel AkanjiManchester City
Toulouse,Umit Akdag,63,ro ROU,DF,fr Ligue 1,20,2003,5.6,8,4,3,4,1,5,12,41.7,7,10,8,2,11,19,19,0,Umit AkdagToulouse
Manchester City,Nathan Ake,64,nl NED,DF,eng Premier League,29,1995,7.5,9,7,7,2,0,4,6,66.7,2,7,2,5,3,12,22,1,Nathan AkeManchester City
Villarreal,Ilias Akhomach,65,ma MAR,"MF,FW",es La Liga,20,2004,6.5,12,7,4,4,4,6,12,50.0,6,8,0,8,3,15,13,0,Ilias AkhomachVillarreal
Reims,Sergio Akieme,66,es ESP,DF,fr Ligue 1,26,1997,28.0,34,23,30,3,1,22,36,61.1,14,26,9,17,17,51,97,4,Sergio AkiemeReims
Monaco,Maghnes Akliouche,67,fr FRA,"FW,MF",fr Ligue 1,22,2002,26.7,51,31,12,24,15,19,41,46.3,22,21,0,21,15,66,13,0,Maghnes AklioucheMonaco
Lyon,Paul Akouokou,68,ci CIV,MF,fr Ligue 1,26,1997,0.2,1,0,0,1,0,0,0,,0,0,0,0,1,2,0,1,Paul AkouokouLyon
Auxerre,Clement Akpa,69,ci CIV,DF,fr Ligue 1,22,2001,27.6,55,34,36,12,7,31,46,67.4,15,38,14,24,42,97,141,2,Clement AkpaAuxerre
Monza,Jean-Daniel Akpa-Akpro,70,ci CIV,MF,it Serie A,31,1992,10.7,30,18,15,14,1,9,21,42.9,12,19,6,13,13,43,16,1,Jean-Daniel Akpa-AkproMonza
Genoa,David Akpan Ankeye,71,ng NGA,"FW,MF",it Serie A,22,2002,0.5,0,0,0,0,0,0,1,0.0,1,0,0,0,0,0,1,0,David Akpan AnkeyeGenoa
Hoffenheim,Kevin Akpoguma,72,ng NGA,DF,de Bundesliga,29,1995,24.7,54,27,36,12,6,30,46,65.2,16,65,37,28,29,83,115,1,Kevin AkpogumaHoffenheim
Lille,Chuba Akpom,73,eng ENG,FW,fr Ligue 1,28,1995,7.1,8,5,0,4,4,2,6,33.3,4,9,0,9,0,8,3,0,Chuba AkpomLille
Real Madrid,David Alaba,74,at AUT,DF,es La Liga,32,1992,3.5,1,0,1,0,0,0,0,,0,5,5,0,6,7,7,0,David AlabaReal Madrid
Valladolid,Ibrahim Alani,75,ng NGA,MF,es La Liga,18,2006,1.8,12,7,8,4,0,4,6,66.7,2,3,1,2,1,13,1,0,Ibrahim AlaniValladolid
St. Pauli,Andreas Albers,76,dk DEN,FW,de Bundesliga,34,1990,0.7,1,1,0,0,1,0,1,0.0,1,0,0,0,0,1,1,0,Andreas AlbersSt. Pauli
Villarreal,Raul Albiol,77,es ESP,DF,es La Liga,38,1985,13.2,10,9,9,1,0,6,10,60.0,4,10,9,1,6,16,69,1,Raul AlbiolVillarreal
Southampton,Carlos Alcaraz,78,ar ARG,MF,eng Premier League,21,2002,0.1,0,0,0,0,0,0,0,,0,0,0,0,1,1,0,0,Carlos AlcarazSouthampton
Everton,Carlos Alcaraz,79,ar ARG,"FW,MF",eng Premier League,21,2002,8.5,11,5,5,3,3,3,11,27.3,8,9,2,7,5,16,10,0,Carlos AlcarazEverton
Getafe,Omar Alderete,80,py PAR,DF,es La Liga,27,1996,33.0,43,29,30,11,2,20,30,66.7,10,38,22,16,40,83,241,1,Omar AldereteGetafe
Getafe,Carles Alena,81,es ESP,"MF,FW",es La Liga,26,1998,5.0,6,3,2,3,1,4,13,30.8,9,9,1,8,0,6,7,0,Carles AlenaGetafe
Alaves,Carles Alena,82,es ESP,"MF,FW",es La Liga,26,1998,12.1,19,12,6,7,6,7,17,41.2,10,11,0,11,2,21,4,0,Carles AlenaAlaves
St. Pauli,Ben Alexander Voll,83,de GER,GK,de Bundesliga,23,2000,1.0,0,0,0,0,0,0,0,,0,0,0,0,0,0,0,0,Ben Alexander VollSt. Pauli
Liverpool,Trent Alexander-Arnold,84,eng ENG,DF,eng Premier League,25,1998,26.3,72,50,44,19,9,49,105,46.7,56,26,9,17,31,103,55,4,Trent Alexander-ArnoldLiverpool
Celta Vigo,Alfon,85,es ESP,"FW,MF",es La Liga,25,1999,15.2,8,3,3,2,3,4,12,33.3,8,8,0,8,5,13,5,1,AlfonCelta Vigo
Nice,Mohamed Ali Cho,86,fr FRA,"FW,MF",fr Ligue 1,20,2004,18.0,13,9,4,5,4,4,12,33.3,8,17,1,16,5,18,8,0,Mohamed Ali ChoNice
Hellas Verona,Faride Alidou,87,de GER,"FW,MF",it Serie A,23,2001,0.8,0,0,0,0,0,0,0,,0,1,0,1,1,1,3,1,Faride AlidouHellas Verona
Liverpool,Alisson,88,br BRA,GK,eng Premier League,31,1992,27.9,1,0,1,0,0,0,1,0.0,1,0,0,0,0,1,13,1,AlissonLiverpool
Celta Vigo,Tadeo Allende,89,ar ARG,FW,es La Liga,25,1999,0.0,0,0,0,0,0,0,0,,0,0,0,0,0,0,0,0,Tadeo AllendeCelta Vigo
Angers,Jim Allevinah,90,ga GAB,FW,fr Ligue 1,29,1995,19.4,19,11,6,9,4,5,28,17.9,23,10,0,10,12,31,17,0,Jim AllevinahAngers
Como,Dele Alli,91,eng ENG,MF,it Serie A,28,1996,0.1,0,0,0,0,0,0,0,,0,0,0,0,0,0,0,0,Dele AlliComo
Lyon,Thiago Almada,92,ar ARG,"MF,FW",fr Ligue 1,23,2001,10.6,14,8,7,5,2,7,21,33.3,14,2,0,2,7,21,6,3,Thiago AlmadaLyon
Valencia,Domingos Andre Ribeiro Almeida,93,pt POR,"MF,FW",es La Liga,24,2000,22.0,48,32,18,21,9,14,39,35.9,25,21,3,18,8,56,14,1,Domingos Andre Ribeiro AlmeidaValencia
Girona,Iker Almena,94,es ESP,"FW,DF",es La Liga,20,2004,0.5,0,0,0,0,0,0,1,0.0,1,1,0,1,0,0,2,0,Iker AlmenaGirona
Newcastle Utd,Miguel Almiron,95,py PAR,FW,eng Premier League,30,1994,1.7,3,2,2,0,1,2,3,66.7,1,2,0,2,0,3,0,0,Miguel AlmironNewcastle Utd
Parma,Pontus Almqvist,96,se SWE,"FW,MF",it Serie A,25,1999,12.4,17,13,7,7,3,8,17,47.1,9,13,0,13,19,36,8,0,Pontus AlmqvistParma
Celta Vigo,Marcos Alonso,97,es ESP,DF,es La Liga,33,1990,29.4,35,21,19,13,3,25,44,56.8,19,22,7,15,34,69,126,4,Marcos AlonsoCelta Vigo
Venezia,Giorgio Altare,98,it ITA,DF,it Serie A,25,1998,8.4,13,12,8,3,2,8,15,53.3,7,21,11,10,17,30,49,0,Giorgio AltareVenezia
Leganes,Adria Altimira,99,es ESP,"DF,FW",es La Liga,23,2001,18.1,41,24,26,12,3,24,40,60.0,16,15,6,9,15,56,54,2,Adria AltimiraLeganes
Betis,Sergi Altimira,100,es ESP,MF,es La Liga,22,2001,21.9,61,37,17,38,6,36,60,60.0,24,28,1,27,24,85,43,3,Sergi AltimiraBetis
Leicester City,Olabade Aluko,101,,DF,eng Premier League,,,0.0,1,1,0,0,1,1,1,100.0,0,0,0,0,0,1,0,0,Olabade AlukoLeicester City
West Ham,Edson Alvarez,102,mx MEX,MF,eng Premier League,26,1997,19.7,50,27,27,15,8,17,35,48.6,18,23,8,15,18,68,46,1,Edson AlvarezWest Ham
Celta Vigo,Hugo Alvarez,103,es ESP,"MF,DF",es La Liga,21,2003,17.5,26,9,12,10,4,10,19,52.6,9,19,2,17,8,34,29,1,Hugo AlvarezCelta Vigo
Atletico Madrid,Julian Alvarez,104,ar ARG,FW,es La Liga,24,2000,27.9,25,17,5,11,9,8,30,26.7,22,14,0,14,2,27,12,1,Julian AlvarezAtletico Madrid
Athletic Club,Yeray Alvarez,105,es ESP,DF,es La Liga,29,1995,19.8,25,13,14,9,2,15,22,68.2,7,10,6,4,34,59,129,1,Yeray AlvarezAthletic Club
Werder Bremen,Skelly Alvero,106,fr FRA,MF,de Bundesliga,22,2002,2.6,11,6,5,5,1,4,5,80.0,1,4,0,4,2,13,10,0,Skelly AlveroWerder Bremen
Leicester City,Will Alves,107,eng ENG,FW,eng Premier League,19,2005,0.0,0,0,0,0,0,0,0,,0,0,0,0,0,0,0,0,Will AlvesLeicester City
Valladolid,Selim Amallah,108,ma MAR,MF,es La Liga,27,1996,15.3,30,18,10,18,2,10,18,55.6,8,24,2,22,14,44,5,1,Selim AmallahValladolid
Manchester Utd,Harry Amass,109,eng ENG,DF,eng Premier League,17,2007,3.8,6,2,5,1,0,2,8,25.0,6,11,1,10,2,8,11,0,Harry AmassManchester Utd
Valladolid,Amath,110,sn SEN,"FW,DF",es La Liga,28,1996,4.2,2,0,2,0,0,1,8,12.5,7,7,1,6,2,4,6,0,AmathValladolid
Brest,Jordan Amavi,111,fr FRA,DF,fr Ligue 1,30,1994,8.8,24,17,10,11,3,15,21,71.4,6,10,2,8,7,31,18,0,Jordan AmaviBrest
Eint Frankfurt,Aurele Amenda,112,ch SUI,DF,de Bundesliga,21,2003,1.1,1,0,1,0,0,0,0,,0,2,2,0,2,3,11,0,Aurele AmendaEint Frankfurt
Nantes,Kelvin Amian,113,fr FRA,DF,fr Ligue 1,26,1998,24.1,55,31,40,14,1,29,35,82.9,6,18,11,7,13,68,85,0,Kelvin AmianNantes
Marseille,Michael Amir Murillo,114,pa PAN,DF,fr Ligue 1,28,1996,27.1,49,31,30,13,6,32,46,69.6,14,21,8,13,18,67,70,4,Michael Amir MurilloMarseille
Mainz 05,Nadiem Amiri,115,de GER,MF,de Bundesliga,27,1996,27.5,50,23,13,28,9,19,46,41.3,27,19,4,15,16,66,30,2,Nadiem AmiriMainz 05
Southampton,Samuel Amo-Ameyaw,116,eng ENG,"FW,DF",eng Premier League,18,2006,0.3,1,0,0,1,0,1,1,100.0,0,0,0,0,0,1,0,0,Samuel Amo-AmeyawSouthampton
Strasbourg,Samuel Amo-Ameyaw,117,eng ENG,"DF,MF",fr Ligue 1,18,2006,3.6,5,3,3,2,0,2,9,22.2,7,3,0,3,3,8,2,0,Samuel Amo-AmeyawStrasbourg
Chelsea,Mathis Amougou,118,fr FRA,MF,eng Premier League,18,2006,0.1,0,0,0,0,0,0,0,,0,0,0,0,0,0,0,0,Mathis AmougouChelsea
Saint-Etienne,Mathis Amougou,119,fr FRA,MF,fr Ligue 1,18,2006,9.5,21,15,15,5,1,10,19,52.6,9,10,0,10,12,33,4,0,Mathis AmougouSaint-Etienne
Wolfsburg,Mohamed Amoura,120,dz ALG,FW,de Bundesliga,24,2000,27.4,29,22,14,5,10,14,37,37.8,23,42,2,40,9,38,24,0,Mohamed AmouraWolfsburg
Fiorentina,Sofyan Amrabat,121,ma MAR,MF,it Serie A,27,1996,2.0,3,2,1,2,0,2,2,100.0,0,1,1,0,0,3,2,0,Sofyan AmrabatFiorentina
Crystal Palace,Joachim Andersen,122,dk DEN,DF,eng Premier League,28,1996,1.0,1,1,1,0,0,1,2,50.0,1,0,0,0,0,1,7,0,Joachim AndersenCrystal Palace
Fulham,Joachim Andersen,123,dk DEN,DF,eng Premier League,28,1996,28.7,27,18,20,6,1,15,24,62.5,9,37,28,9,34,61,188,1,Joachim AndersenFulham
Nott'ham Forest,Elliot Anderson,124,eng ENG,MF,eng Premier League,21,2002,30.3,92,56,54,29,9,48,111,43.2,63,48,9,39,31,123,76,4,Elliot AndersonNott'ham Forest
Wolves,Andre,125,br BRA,MF,eng Premier League,23,2001,27.5,91,55,41,41,9,37,63,58.7,26,42,8,34,37,128,30,1,AndreWolves
Lille,Benjamin Andre,126,fr FRA,MF,fr Ligue 1,33,1990,29.9,103,57,31,60,12,54,96,56.3,42,42,6,36,48,151,56,0,Benjamin AndreLille
Valladolid,Marcos Andre,127,br BRA,FW,es La Liga,27,1996,13.2,10,6,3,5,2,5,13,38.5,8,18,2,16,3,13,10,0,Marcos AndreValladolid
Leverkusen,Robert Andrich,128,de GER,"MF,DF",de Bundesliga,29,1994,17.8,24,12,8,14,2,7,14,50.0,7,16,8,8,29,53,23,0,Robert AndrichLeverkusen
Roma,Angelino,129,es ESP,DF,it Serie A,27,1997,35.3,46,24,20,24,2,17,34,50.0,17,33,9,24,28,74,98,0,AngelinoRoma
Juventus,Lorenzo Anghele,130,it ITA,FW,it Serie A,19,2005,0.1,0,0,0,0,0,0,0,,0,0,0,0,0,0,0,0,Lorenzo AngheleJuventus
Empoli,Faustino Anjorin,131,eng ENG,MF,it Serie A,22,2001,12.4,29,13,9,14,6,9,18,50.0,9,18,3,15,13,42,20,0,Faustino AnjorinEmpoli
Dortmund,Waldemar Anton,132,de GER,DF,de Bundesliga,28,1996,21.7,34,21,18,10,6,17,23,73.9,6,33,16,17,30,64,112,1,Waldemar AntonDortmund
Sevilla,Leandro Antonetti,133,pr PUR,FW,es La Liga,21,2003,0.3,0,0,0,0,0,0,0,,0,0,0,0,0,0,0,0,Leandro AntonettiSevilla
Lens,Kyllian Antonio,134,fr FRA,"DF,MF",fr Ligue 1,16,2008,1.5,3,2,2,0,1,1,3,33.3,2,3,0,3,3,6,3,1,Kyllian AntonioLens
West Ham,Michail Antonio,135,jm JAM,FW,eng Premier League,34,1990,9.3,2,2,0,1,1,2,3,66.7,1,6,0,6,0,2,2,0,Michail AntonioWest Ham
Espanyol,Antoniu,136,es ESP,"FW,MF",es La Liga,21,2002,11.4,21,10,9,8,4,9,21,42.9,12,14,2,12,8,29,11,1,AntoniuEspanyol
Manchester Utd,Antony,137,br BRA,"DF,MF",eng Premier League,24,2000,1.6,6,3,4,2,0,2,5,40.0,3,2,0,2,2,8,0,0,AntonyManchester Utd
Betis,Antony,138,br BRA,FW,es La Liga,24,2000,15.1,25,11,6,9,10,8,22,36.4,14,12,1,11,10,35,9,1,AntonyBetis
Valladolid,Anuar,139,ma MAR,"MF,FW",es La Liga,29,1995,19.1,38,27,21,12,5,15,28,53.6,13,24,8,16,18,56,26,1,AnuarValladolid
Saint-Etienne,Dennis Appiah,140,fr FRA,DF,fr Ligue 1,32,1992,23.6,71,43,42,22,7,41,71,57.7,30,36,8,28,29,100,89,2,Dennis AppiahSaint-Etienne
Leganes,Aritz Arambarri,141,es ESP,DF,es La Liga,26,1998,2.0,1,1,1,0,0,1,1,100.0,0,2,2,0,3,4,8,0,Aritz ArambarriLeganes
Getafe,Mauro Arambarri,142,uy URU,MF,es La Liga,28,1995,29.6,48,29,10,33,5,22,48,45.8,26,35,6,29,15,63,46,0,Mauro ArambarriGetafe
Real Sociedad,Jon Aramburu,143,ve VEN,DF,es La Liga,22,2002,27.3,102,70,61,30,11,66,100,66.0,34,40,8,32,30,132,98,0,Jon AramburuReal Sociedad
Bournemouth,Julian Araujo,144,mx MEX,DF,eng Premier League,22,2001,5.5,10,5,4,6,0,5,12,41.7,7,3,0,3,6,16,18,0,Julian AraujoBournemouth
Barcelona,Ronald Araujo,145,uy URU,DF,es La Liga,25,1999,8.4,12,9,6,5,1,4,5,80.0,1,6,4,2,9,21,25,0,Ronald AraujoBarcelona
Southampton,Cameron Archer,146,eng ENG,FW,eng Premier League,23,2001,16.0,13,8,8,3,2,2,9,22.2,7,5,1,4,2,15,11,0,Cameron ArcherSouthampton
Angers,Carlens Arcus,147,ht HAI,DF,fr Ligue 1,28,1996,22.7,52,35,32,15,5,34,56,60.7,22,24,4,20,27,79,83,3,Carlens ArcusAngers
West Ham,Alphonse Areola,148,fr FRA,GK,eng Premier League,31,1993,25.1,2,2,2,0,0,2,3,66.7,1,0,0,0,0,2,15,3,Alphonse AreolaWest Ham
Athletic Club,Adu Ares,149,es ESP,FW,es La Liga,22,2001,0.2,0,0,0,0,0,0,1,0.0,1,0,0,0,0,0,0,0,Adu AresAthletic Club
Osasuna,Jesus Areso,150,es ESP,DF,es La Liga,25,1999,34.2,53,38,31,14,8,39,56,69.6,17,26,4,22,8,61,92,0,Jesus AresoOsasuna
Getafe,David Arguelles,151,es ESP,MF,es La Liga,22,2002,0.1,0,0,0,0,0,0,0,,0,2,0,2,0,0,0,0,David ArguellesGetafe
Southampton,Joe Aribo,152,ng NGA,"MF,DF",eng Premier League,28,1996,22.4,47,33,17,24,6,17,35,48.6,18,28,11,17,20,67,32,3,Joe AriboSouthampton
Southampton,Adam Armstrong,153,eng ENG,"FW,MF",eng Premier League,27,1997,13.9,12,3,2,7,3,3,14,21.4,11,6,1,5,3,15,8,0,Adam ArmstrongSouthampton
Everton,Harrison Armstrong,154,eng ENG,MF,eng Premier League,17,2007,0.5,0,0,0,0,0,0,1,0.0,1,0,0,0,0,0,1,0,Harrison ArmstrongEverton
Osasuna,Jose Arnaiz,155,es ESP,"FW,MF",es La Liga,29,1995,1.5,7,5,3,3,1,4,7,57.1,3,2,0,2,5,12,1,0,Jose ArnaizOsasuna
Lille,Hakon Arnar Haraldsson,156,is ISL,"MF,FW",fr Ligue 1,21,2003,19.5,36,16,9,17,10,16,33,48.5,17,10,2,8,8,44,6,0,Hakon Arnar HaraldssonLille
Inter,Marko Arnautovic,157,at AUT,FW,it Serie A,35,1989,5.9,7,5,1,3,3,3,5,60.0,2,3,0,3,1,8,1,0,Marko ArnautovicInter
Wolfsburg,Maximilian Arnold,158,de GER,MF,de Bundesliga,30,1994,26.2,34,20,13,18,3,15,33,45.5,18,21,11,10,24,58,70,2,Maximilian ArnoldWolfsburg
Holstein Kiel,Jann-Fiete Arp,159,de GER,"FW,MF",de Bundesliga,24,2000,7.9,13,10,5,2,6,4,13,30.8,9,6,0,6,3,16,8,1,Jann-Fiete ArpHolstein Kiel
Betis,Sergio Arribas,160,es ESP,DF,es La Liga,21,2003,1.0,7,4,4,3,0,6,7,85.7,1,2,2,0,3,10,4,0,Sergio ArribasBetis
Bournemouth,Kepa Arrizabalaga,161,es ESP,GK,eng Premier League,29,1994,31.0,1,0,1,0,0,0,2,0.0,2,2,0,2,0,1,15,3,Kepa ArrizabalagaBournemouth
Leverkusen,Arthur,162,br BRA,DF,de Bundesliga,21,2003,8.4,14,11,3,9,2,5,10,50.0,5,8,0,8,9,23,29,0,ArthurLeverkusen
Mallorca,Takuma Asano,163,jp JPN,"FW,MF",es La Liga,29,1994,11.7,13,9,5,7,1,6,11,54.5,5,7,0,7,6,19,9,0,Takuma AsanoMallorca
Real Madrid,Raul Asencio,164,es ESP,DF,es La Liga,21,2003,18.6,22,16,18,4,0,10,13,76.9,3,11,6,5,16,38,88,2,Raul AsencioReal Madrid
Aston Villa,Marco Asensio,165,es ESP,MF,eng Premier League,28,1996,8.3,7,5,0,7,0,3,9,33.3,6,7,1,6,2,9,3,0,Marco AsensioAston Villa
Paris S-G,Marco Asensio,166,es ESP,"FW,MF",fr Ligue 1,28,1996,6.9,4,3,1,3,0,0,6,0.0,6,1,0,1,0,4,1,0,Marco AsensioParis S-G
Inter,Kristjan Asllani,167,al ALB,MF,it Serie A,22,2002,10.9,14,3,8,4,2,8,22,36.4,14,8,1,7,9,23,13,1,Kristjan AsllaniInter
Celta Vigo,Iago Aspas,168,es ESP,"FW,MF",es La Liga,36,1987,19.4,13,8,4,5,4,8,20,40.0,12,18,1,17,8,21,5,0,Iago AspasCelta Vigo
Girona,Yaser Asprilla,169,co COL,"FW,MF",es La Liga,20,2003,15.6,22,12,6,8,8,8,23,34.8,15,14,0,14,7,29,7,1,Yaser AsprillaGirona
Rennes,Lorenz Assignon,170,tg TOG,"DF,MF",fr Ligue 1,24,2000,26.2,49,27,25,22,2,19,43,44.2,24,20,3,17,25,74,74,0,Lorenz AssignonRennes
Nantes,Dehmaine Assoumani,171,fr FRA,"MF,FW",fr Ligue 1,19,2005,1.1,6,3,0,4,2,4,5,80.0,1,1,0,1,1,7,4,0,Dehmaine AssoumaniNantes
Reims,Valentin Atangana Edoa,172,fr FRA,MF,fr Ligue 1,18,2005,31.7,69,50,32,30,7,28,38,73.7,10,31,15,16,37,106,64,0,Valentin Atangana EdoaReims
Udinese,Arthur Atta,173,fr FRA,"MF,FW",it Serie A,21,2003,13.9,20,12,9,10,1,10,15,66.7,5,9,5,4,7,27,15,1,Arthur AttaUdinese
Freiburg,Noah Atubolu,174,de GER,GK,de Bundesliga,22,2002,25.6,0,0,0,0,0,0,0,,0,0,0,0,0,0,13,4,Noah AtuboluFreiburg
Como,Emil Audero,175,id IDN,GK,it Serie A,27,1997,8.0,0,0,0,0,0,0,1,0.0,1,0,0,0,0,0,4,1,Emil AuderoComo
Cagliari,Tommaso Augello,176,it ITA,DF,it Serie A,29,1994,30.1,49,28,28,17,4,30,43,69.8,13,23,8,15,16,65,109,2,Tommaso AugelloCagliari
Inter,Carlos Augusto,177,br BRA,DF,it Serie A,25,1999,18.1,29,14,12,11,6,12,19,63.2,7,21,9,12,9,38,50,0,Carlos AugustoInter
Inter,Yann Aurel Bisseck,178,de GER,DF,it Serie A,23,2000,17.3,17,11,11,4,2,11,16,68.8,5,23,12,11,17,34,64,1,Yann Aurel BisseckInter
Tottenham,Brandon Austin,179,eng ENG,GK,eng Premier League,25,1999,1.0,0,0,0,0,0,0,0,,0,0,0,0,0,0,1,0,Brandon AustinTottenham
Betis,Ezequiel Avila,180,ar ARG,FW,es La Liga,30,1994,7.5,8,3,2,2,4,4,10,40.0,6,4,0,4,2,10,8,0,Ezequiel AvilaBetis
Nott'ham Forest,Taiwo Awoniyi,181,ng NGA,FW,eng Premier League,26,1997,4.6,6,3,0,3,3,4,5,80.0,1,1,0,1,0,6,7,0,Taiwo AwoniyiNott'ham Forest
Brighton,Yasin Ayari,182,se SWE,MF,eng Premier League,20,2003,21.8,59,32,15,31,13,26,56,46.4,30,24,6,18,20,79,26,0,Yasin AyariBrighton
Auxerre,Florian Aye,183,fr FRA,FW,fr Ligue 1,27,1997,6.4,2,2,0,0,2,0,2,0.0,2,7,0,7,7,9,6,0,Florian AyeAuxerre
Le Havre,Andre Ayew,184,gh GHA,FW,fr Ligue 1,34,1989,16.1,18,10,3,7,8,7,13,53.8,6,9,2,7,3,21,21,1,Andre AyewLe Havre
Crystal Palace,Jordan Ayew,185,gh GHA,"FW,MF",eng Premier League,32,1991,0.2,1,0,0,0,1,0,0,,0,0,0,0,0,1,0,0,Jordan AyewCrystal Palace
Leicester City,Jordan Ayew,186,gh GHA,"FW,MF",eng Premier League,32,1991,18.2,27,15,8,14,5,7,23,30.4,16,21,2,19,12,39,19,0,Jordan AyewLeicester City
Lens,Neil El Aynaoui,187,fr FRA,MF,fr Ligue 1,23,2001,17.6,39,21,18,15,6,12,34,35.3,22,34,8,26,30,69,29,0,Neil El AynaouiLens
Dortmund,Ayman Azhil,188,ma MAR,MF,de Bundesliga,23,2001,0.3,1,1,1,0,0,0,0,,0,0,0,0,0,1,0,0,Ayman AzhilDortmund
Valladolid,Adam Aznou,189,ma MAR,DF,es La Liga,18,2006,9.7,28,21,20,8,0,21,43,48.8,22,24,8,16,10,38,30,0,Adam AznouValladolid
Bayern Munich,Adam Aznou,190,ma MAR,DF,de Bundesliga,18,2006,0.2,0,0,0,0,0,0,0,,0,0,0,0,0,0,1,0,Adam AznouBayern Munich
Atletico Madrid,Cesar Azpilicueta,191,es ESP,DF,es La Liga,34,1989,9.7,25,14,12,9,4,17,23,73.9,6,10,2,8,5,30,32,0,Cesar AzpilicuetaAtletico Madrid
Cagliari,Paulo Azzi,192,br BRA,DF,it Serie A,30,1994,4.7,11,9,3,6,2,5,9,55.6,4,5,2,3,5,16,11,0,Paulo AzziCagliari
Bologna,Oussama El Azzouzi,193,ma MAR,MF,it Serie A,23,2001,0.2,0,0,0,0,0,0,0,,0,0,0,0,2,2,0,0,Oussama El AzzouziBologna
Girona,Papa Ba,194,es ESP,MF,es La Liga,19,2004,0.5,1,1,1,0,0,0,0,,0,1,0,1,0,1,1,0,Papa BaGirona
Toulouse,Shavy Babicka,195,ga GAB,"MF,FW",fr Ligue 1,24,2000,13.2,21,12,6,11,4,10,21,47.6,11,14,0,14,3,24,4,3,Shavy BabickaToulouse
Empoli,Jacopo Bacci,196,it ITA,MF,it Serie A,19,2005,0.3,1,0,1,0,0,1,1,100.0,0,0,0,0,1,2,1,0,Jacopo BacciEmpoli
Bochum,Aliou Badara Balde,197,gn GUI,"MF,FW",de Bundesliga,21,2002,1.0,1,1,1,0,0,0,0,,0,2,0,2,0,1,0,0,Aliou Badara BaldeBochum
Sevilla,Loic Bade,198,fr FRA,DF,es La Liga,24,2000,29.8,47,27,37,10,0,23,31,74.2,8,22,13,9,29,76,162,2,Loic BadeSevilla
Genoa,Milan Badelj,199,hr CRO,MF,it Serie A,35,1989,16.4,29,16,14,10,5,15,35,42.9,20,19,7,12,20,49,43,0,Milan BadeljGenoa
Chelsea,Benoit Badiashile,200,fr FRA,DF,eng Premier League,23,2001,3.7,9,6,5,4,0,4,5,80.0,1,2,2,0,6,15,12,2,Benoit BadiashileChelsea
Villarreal,Alex Baena,201,es ESP,"MF,FW",es La Liga,23,2001,28.8,28,15,6,14,8,10,39,25.6,29,29,2,27,22,50,22,2,Alex BaenaVillarreal
Valladolid,Juma Bah,202,sl SLE,DF,es La Liga,18,2006,9.6,10,7,7,3,0,3,5,60.0,2,15,8,7,12,22,60,0,Juma BahValladolid
Lens,Juma Bah,203,sl SLE,DF,fr Ligue 1,18,2006,7.6,16,10,6,10,0,5,7,71.4,2,10,7,3,17,33,47,1,Juma BahLens
Aston Villa,Leon Bailey,204,jm JAM,"FW,MF",eng Premier League,26,1997,12.7,7,5,2,3,2,3,11,27.3,8,6,0,6,3,10,12,0,Leon BaileyAston Villa
Villarreal,Eric Bailly,205,ci CIV,DF,es La Liga,30,1994,6.9,12,4,6,6,0,3,4,75.0,1,12,6,6,6,18,29,0,Eric BaillyVillarreal
Auxerre,Theo Bair,206,ca CAN,FW,fr Ligue 1,24,1999,10.4,4,3,1,2,1,0,2,0.0,2,6,2,4,3,7,10,0,Theo BairAuxerre
Las Palmas,Stefan Bajcetic,207,es ESP,"MF,DF",es La Liga,19,2004,10.8,29,14,13,13,3,12,28,42.9,16,25,4,21,15,44,26,1,Stefan BajceticLas Palmas
Betis,Cedric Bakambu,208,cd COD,FW,es La Liga,33,1991,7.9,6,4,0,5,1,3,7,42.9,4,13,2,11,0,6,5,0,Cedric BakambuBetis
Atalanta,Mitchel Bakker,209,nl NED,MF,it Serie A,24,2000,0.2,1,0,1,0,0,1,1,100.0,0,0,0,0,0,1,0,0,Mitchel BakkerAtalanta
Lille,Mitchel Bakker,210,nl NED,"FW,DF",fr Ligue 1,24,2000,12.7,23,13,6,11,6,10,19,52.6,9,10,1,9,12,35,15,0,Mitchel BakkerLille
Marseille,Darryl Bakola,211,fr FRA,"DF,MF",fr Ligue 1,16,2007,0.2,1,1,0,1,0,0,0,,0,0,0,0,0,1,0,0,Darryl BakolaMarseille
Wolfsburg,Ridle Baku,212,de GER,"FW,MF",de Bundesliga,26,1998,13.0,23,15,9,9,5,8,19,42.1,11,22,1,21,15,38,15,0,Ridle BakuWolfsburg
RB Leipzig,Ridle Baku,213,de GER,"DF,MF",de Bundesliga,26,1998,14.2,24,19,9,13,2,9,23,39.1,14,18,2,16,9,33,45,0,Ridle BakuRB Leipzig
Strasbourg,Dilane Bakwa,214,fr FRA,"MF,DF",fr Ligue 1,21,2002,27.7,26,14,11,8,7,12,24,50.0,12,21,1,20,15,41,27,0,Dilane BakwaStrasbourg
Roma,Tommaso Baldanzi,215,it ITA,"MF,FW",it Serie A,21,2003,9.2,12,4,5,4,3,4,12,33.3,8,4,0,4,6,18,8,0,Tommaso BaldanziRoma
Barcelona,Alejandro Balde,216,es ESP,DF,es La Liga,20,2003,25.4,18,10,10,5,3,11,17,64.7,6,24,5,19,5,23,27,0,Alejandro BaldeBarcelona
Monza,Keita Balde,217,sn SEN,FW,it Serie A,29,1995,7.1,1,1,0,1,0,1,2,50.0,1,4,0,4,2,3,0,0,Keita BaldeMonza
Brighton,Carlos Baleba,218,cm CMR,MF,eng Premier League,20,2004,29.6,79,46,26,37,16,48,80,60.0,32,47,11,36,46,125,44,1,Carlos BalebaBrighton
Marseille,Leonardo Balerdi,219,ar ARG,DF,fr Ligue 1,25,1999,25.3,54,39,32,17,5,27,47,57.4,20,25,14,11,38,92,72,4,Leonardo BalerdiMarseille
Rayo Vallecano,Ivan Balliu,220,al ALB,DF,es La Liga,32,1992,13.3,17,14,8,5,4,6,18,33.3,12,16,4,12,13,30,39,0,Ivan BalliuRayo Vallecano
Le Havre,Fode Ballo-Toure,221,sn SEN,"DF,MF",fr Ligue 1,27,1997,6.5,8,7,3,4,1,5,9,55.6,4,8,3,5,4,12,27,0,Fode Ballo-ToureLe Havre
Parma,Botond Balogh,222,hu HUN,DF,it Serie A,22,2002,22.8,36,16,22,13,1,20,28,71.4,8,34,26,8,25,61,141,2,Botond BaloghParma
Monaco,Folarin Balogun,223,us USA,FW,fr Ligue 1,23,2001,6.8,1,1,0,0,1,0,4,0.0,4,0,0,0,1,2,0,0,Folarin BalogunMonaco
Genoa,Mario Balotelli,224,it ITA,"FW,MF",it Serie A,33,1990,0.7,0,0,0,0,0,0,0,,0,0,0,0,0,0,1,0,Mario BalotelliGenoa
Angers,Abdoulaye Bamba,225,ci CIV,DF,fr Ligue 1,34,1990,16.8,22,12,17,4,1,14,19,73.7,5,14,8,6,19,41,79,0,Abdoulaye BambaAngers
Celta Vigo,Jonathan Bamba,226,ci CIV,"FW,MF",es La Liga,28,1996,9.0,12,7,4,6,2,5,12,41.7,7,6,0,6,5,17,6,0,Jonathan BambaCelta Vigo
Reims,Mohamed Bamba,227,ci CIV,MF,fr Ligue 1,19,2004,0.1,0,0,0,0,0,0,1,0.0,1,2,1,1,0,0,1,0,Mohamed BambaReims
Bochum,Samuel Bamba,228,de GER,"FW,MF",de Bundesliga,20,2004,0.3,1,1,1,0,0,0,0,,0,0,0,0,0,1,0,0,Samuel BambaBochum
Lecce,Lameck Banda,229,zm ZAM,"FW,MF",it Serie A,23,2001,6.8,8,5,4,2,2,3,12,25.0,9,7,0,7,2,10,8,1,Lameck BandaLecce
Hellas Verona,Daniel Bandeira,230,pt POR,MF,it Serie A,24,2000,4.5,4,0,1,3,0,3,6,50.0,3,2,1,1,6,10,8,0,Daniel BandeiraHellas Verona
Genoa,Mattia Bani,231,it ITA,DF,it Serie A,30,1993,16.7,19,10,11,6,2,7,11,63.6,4,13,8,5,22,41,85,2,Mattia BaniGenoa
Augsburg,Noahkai Banks,232,us USA,DF,de Bundesliga,17,2006,3.1,11,5,6,4,1,3,7,42.9,4,4,1,3,5,16,28,0,Noahkai BanksAugsburg
St. Pauli,Scott Banks,233,sct SCO,"FW,MF",de Bundesliga,22,2001,1.3,1,1,1,0,0,0,2,0.0,2,0,0,0,2,3,2,0,Scott BanksSt. Pauli
Valladolid,Adrian Baquerin,234,es ESP,FW,es La Liga,17,2007,0.5,1,1,0,1,0,0,0,,0,0,0,0,0,1,1,0,Adrian BaquerinValladolid
Fiorentina,Antonin Barak,235,cz CZE,MF,it Serie A,29,1994,0.6,2,0,0,2,0,0,2,0.0,2,1,1,0,0,2,0,0,Antonin BarakFiorentina
Como,Federico Barba,236,it ITA,DF,it Serie A,30,1993,4.8,2,2,1,1,0,1,4,25.0,3,2,2,0,4,6,15,0,Federico BarbaComo
Sevilla,Valentin Barco,237,ar ARG,"DF,FW",es La Liga,20,2004,3.2,15,9,8,3,4,12,15,80.0,3,0,0,0,2,17,5,0,Valentin BarcoSevilla
Strasbourg,Valentin Barco,238,ar ARG,"MF,DF",fr Ligue 1,20,2004,12.9,36,22,24,10,2,22,30,73.3,8,8,3,5,13,49,28,1,Valentin BarcoStrasbourg
Paris S-G,Bradley Barcola,239,fr FRA,FW,fr Ligue 1,21,2002,24.2,27,17,10,8,9,8,31,25.8,23,25,2,23,19,46,12,0,Bradley BarcolaParis S-G
Nice,Melvin Bard,240,fr FRA,"DF,MF",fr Ligue 1,23,2000,21.5,53,36,35,13,5,24,42,57.1,18,38,13,25,29,82,60,3,Melvin BardNice
Inter,Nicolo Barella,241,it ITA,MF,it Serie A,27,1997,27.3,50,31,19,20,11,26,59,44.1,33,26,3,23,12,62,16,1,Nicolo BarellaInter
Montpellier,Gabriel Bares,242,ch SUI,"MF,DF",fr Ligue 1,23,2000,0.6,2,2,2,0,0,1,2,50.0,1,0,0,0,1,3,3,0,Gabriel BaresMontpellier
Leganes,Borna Barisic,243,hr CRO,DF,es La Liga,31,1992,0.1,0,0,0,0,0,0,0,,0,0,0,0,0,0,0,0,Borna BarisicLeganes
Lyon,Teo Barisic,244,fr FRA,DF,fr Ligue 1,19,2004,0.0,0,0,0,0,0,0,0,,0,0,0,0,0,0,1,0,Teo BarisicLyon
Osasuna,Kike Barja,245,es ESP,"FW,MF",es La Liga,27,1997,3.5,5,4,1,3,1,2,4,50.0,2,5,0,5,3,8,4,0,Kike BarjaOsasuna
Aston Villa,Ross Barkley,246,eng ENG,MF,eng Premier League,30,1993,6.5,14,3,4,10,0,9,14,64.3,5,9,3,6,10,24,5,0,Ross BarkleyAston Villa
Mainz 05,Aymen Barkok,247,ma MAR,MF,de Bundesliga,26,1998,0.8,2,1,1,1,0,1,1,100.0,0,1,1,0,2,4,0,0,Aymen BarkokMainz 05
Newcastle Utd,Harvey Barnes,248,eng ENG,FW,eng Premier League,26,1997,19.5,16,9,4,6,6,3,11,27.3,8,8,2,6,6,22,15,1,Harvey BarnesNewcastle Utd
Valencia,Enzo Barrenechea,249,ar ARG,MF,es La Liga,23,2001,24.3,57,30,22,29,6,32,46,69.6,14,30,8,22,28,85,48,1,Enzo BarrenecheaValencia
Real Sociedad,Ander Barrenetxea,250,es ESP,"MF,FW",es La Liga,22,2001,14.0,26,19,7,14,5,6,23,26.1,17,15,0,15,11,37,16,1,Ander BarrenetxeaReal Sociedad
Atletico Madrid,Pablo Barrios,251,es ESP,MF,es La Liga,21,2003,25.9,46,26,23,20,3,23,47,48.9,24,18,5,13,34,80,33,9,Pablo BarriosAtletico Madrid
Villarreal,Thierno Barry,252,fr FRA,FW,es La Liga,21,2002,25.8,11,8,2,5,4,4,10,40.0,6,15,2,13,0,11,19,0,Thierno BarryVillarreal
Milan,Davide Bartesaghi,253,it ITA,DF,it Serie A,18,2005,1.3,4,2,1,1,2,4,4,100.0,0,1,1,0,3,7,1,0,Davide BartesaghiMilan
Betis,Marc Bartra,254,es ESP,DF,es La Liga,33,1991,23.3,33,19,20,13,0,15,26,57.7,11,41,25,16,33,66,148,0,Marc BartraBetis
Lecce,Federico Baschirotto,255,it ITA,DF,it Serie A,27,1996,38.0,37,25,30,5,2,22,28,78.6,6,44,32,12,23,60,237,2,Federico BaschirottoLecce
Como,Daniele Baselli,256,it ITA,MF,it Serie A,32,1992,0.2,0,0,0,0,0,0,0,,0,0,0,0,1,1,1,0,Daniele BaselliComo
Fulham,Calvin Bassey,257,ng NGA,DF,eng Premier League,24,1999,34.2,54,34,35,19,0,22,31,71.0,9,40,17,23,20,74,118,8,Calvin BasseyFulham
Las Palmas,Aboubacar Bassinga,258,ci CIV,MF,es La Liga,19,2005,0.0,0,0,0,0,0,0,0,,0,0,0,0,0,0,0,0,Aboubacar BassingaLas Palmas
Inter,Alessandro Bastoni,259,it ITA,DF,it Serie A,25,1999,25.9,46,23,26,14,6,20,30,66.7,10,25,13,12,21,67,52,1,Alessandro BastoniInter
Rayo Vallecano,Augusto Batalla,260,ar ARG,GK,es La Liga,28,1996,32.0,4,2,4,0,0,4,6,66.7,2,0,0,0,0,4,15,4,Augusto BatallaRayo Vallecano
Eint Frankfurt,Michy Batshuayi,261,be BEL,FW,de Bundesliga,30,1993,3.3,1,1,1,0,0,1,1,100.0,0,2,0,2,1,2,0,0,Michy BatshuayiEint Frankfurt
Saint-Etienne,Dylan Batubinsika,262,cd COD,DF,fr Ligue 1,28,1996,22.4,26,13,19,6,1,13,22,59.1,9,23,14,9,39,65,140,3,Dylan BatubinsikaSaint-Etienne
Augsburg,Maximilian Bauer,263,de GER,DF,de Bundesliga,24,2000,7.3,14,8,5,7,2,9,14,64.3,5,10,4,6,6,20,35,1,Maximilian BauerAugsburg
Hoffenheim,Oliver Baumann,264,de GER,GK,de Bundesliga,34,1990,28.0,2,2,2,0,0,2,4,50.0,2,0,0,0,0,2,15,2,Oliver BaumannHoffenheim
RB Leipzig,Christoph Baumgartner,265,at AUT,MF,de Bundesliga,24,1999,17.9,44,28,13,19,12,17,42,40.5,25,45,9,36,12,56,24,2,Christoph BaumgartnerRB Leipzig
Espanyol,Rafael Bauza,266,es ESP,MF,es La Liga,19,2005,2.0,5,3,3,1,1,4,7,57.1,3,3,1,2,0,5,5,0,Rafael BauzaEspanyol
Manchester Utd,Altay Bayindir,267,tr TUR,GK,eng Premier League,26,1998,4.0,0,0,0,0,0,0,1,0.0,1,0,0,0,0,0,9,1,Altay BayindirManchester Utd
Hoffenheim,Ihlas Bebou,268,tg TOG,MF,de Bundesliga,30,1994,0.1,0,0,0,0,0,0,0,,0,0,0,0,0,0,0,0,Ihlas BebouHoffenheim
Heidenheim,Adrian Beck,269,de GER,"MF,FW",de Bundesliga,27,1997,17.8,36,17,18,12,6,12,35,34.3,23,31,2,29,9,45,17,0,Adrian BeckHeidenheim
Real Sociedad,Sheraldo Becker,270,sr SUR,"FW,MF",es La Liga,29,1995,11.1,3,2,0,3,0,0,2,0.0,2,4,0,4,1,4,10,0,Sheraldo BeckerReal Sociedad
Holstein Kiel,Timo Becker,271,de GER,DF,de Bundesliga,27,1997,27.2,53,33,39,9,5,34,46,73.9,12,30,17,13,17,70,110,1,Timo BeckerHolstein Kiel
Southampton,Jan Bednarek,272,pl POL,DF,eng Premier League,28,1996,28.1,36,19,23,13,0,16,31,51.6,15,47,36,11,56,92,190,5,Jan BednarekSouthampton
Girona,Donny van de Beek,273,nl NED,MF,es La Liga,27,1997,15.8,29,18,17,7,5,13,26,50.0,13,19,3,16,10,39,12,0,Donny van de BeekGirona
Hoffenheim,Hannes Behrens,274,de GER,DF,de Bundesliga,,,0.3,1,1,0,1,0,0,0,,0,1,0,1,2,3,0,0,Hannes BehrensHoffenheim
Wolfsburg,Kevin Behrens,275,de GER,FW,de Bundesliga,33,1991,1.9,1,1,0,1,0,0,1,0.0,1,0,0,0,1,2,2,0,Kevin BehrensWolfsburg
Dortmund,Maximilian Beier,276,de GER,"FW,MF",de Bundesliga,21,2002,17.7,25,16,8,11,6,12,31,38.7,19,15,1,14,7,32,14,1,Maximilian BeierDortmund
Real Sociedad,Luken Beitia,277,es ESP,DF,es La Liga,20,2004,0.1,1,1,1,0,0,1,1,100.0,0,0,0,0,0,1,2,0,Luken BeitiaReal Sociedad
Getafe,Ismael Bekhoucha,278,ma MAR,"MF,DF",es La Liga,19,2004,0.8,1,1,1,0,0,1,2,50.0,1,2,1,1,2,3,2,0,Ismael BekhouchaGetafe
Hellas Verona,Reda Belahyane,279,ma MAR,MF,it Serie A,20,2004,18.4,36,26,16,13,7,13,17,76.5,4,20,9,11,10,46,22,1,Reda BelahyaneHellas Verona
Lazio,Reda Belahyane,280,ma MAR,MF,it Serie A,20,2004,2.2,8,6,8,0,0,6,6,100.0,0,3,2,1,1,9,5,0,Reda BelahyaneLazio
Angers,Haris Belkebla,281,dz ALG,MF,fr Ligue 1,30,1994,19.9,56,38,38,15,3,26,45,57.8,19,30,9,21,35,91,46,1,Haris BelkeblaAngers
Angers,Yassin Belkhdim,282,fr FRA,MF,fr Ligue 1,22,2002,16.9,53,27,26,21,6,27,58,46.6,31,23,6,17,21,74,41,1,Yassin BelkhdimAngers
Mainz 05,Stefan Bell,283,de GER,DF,de Bundesliga,32,1991,16.0,22,12,16,6,0,9,14,64.3,5,16,14,2,28,50,107,1,Stefan BellMainz 05
Southampton,Armel Bella Kotchap,284,de GER,DF,eng Premier League,22,2001,3.7,7,5,5,2,0,3,6,50.0,3,2,2,0,5,12,21,1,Armel Bella KotchapSouthampton
Torino,Raoul Bellanova,285,it ITA,DF,it Serie A,24,2000,1.0,0,0,0,0,0,0,1,0.0,1,0,0,0,0,0,4,0,Raoul BellanovaTorino
Atalanta,Raoul Bellanova,286,it ITA,DF,it Serie A,24,2000,26.7,24,14,8,13,3,13,21,61.9,8,12,3,9,18,42,45,0,Raoul BellanovaAtalanta
Wolves,Jean-Ricner Bellegarde,287,fr FRA,"MF,FW",eng Premier League,26,1998,18.6,39,24,17,19,3,14,20,70.0,6,19,3,16,10,49,18,1,Jean-Ricner BellegardeWolves
Betis,Hector Bellerin,288,es ESP,DF,es La Liga,29,1995,6.4,13,7,7,4,2,10,17,58.8,7,5,3,2,6,19,21,0,Hector BellerinBetis
Real Madrid,Jude Bellingham,289,eng ENG,MF,es La Liga,21,2003,27.6,61,33,20,27,14,28,42,66.7,14,37,2,35,28,89,23,1,Jude BellinghamReal Madrid
Leverkusen,Jeanuel Belocian,290,fr FRA,"DF,MF",de Bundesliga,19,2005,0.8,1,1,1,0,0,1,1,100.0,0,0,0,0,0,1,2,0,Jeanuel BelocianLeverkusen
Como,Andrea Belotti,291,it ITA,FW,it Serie A,30,1993,6.6,7,5,1,4,2,1,4,25.0,3,4,0,4,1,8,8,0,Andrea BelottiComo
Celta Vigo,Fran Beltran,292,es ESP,MF,es La Liga,25,1999,26.9,50,35,24,21,5,24,56,42.9,32,26,6,20,26,76,34,4,Fran BeltranCelta Vigo
Fiorentina,Lucas Beltran,293,ar ARG,"FW,MF",it Serie A,23,2001,20.7,23,10,10,7,6,7,21,33.3,14,15,2,13,5,28,14,0,Lucas BeltranFiorentina
Monaco,Eliesse Ben Seghir,294,ma MAR,"MF,FW",fr Ligue 1,19,2005,19.4,31,22,12,12,7,18,32,56.3,14,20,0,20,13,44,4,0,Eliesse Ben SeghirMonaco
Alaves,Carlos Benavidez,295,uy URU,MF,es La Liga,26,1998,5.4,19,14,10,6,3,6,11,54.5,5,5,2,3,8,27,14,1,Carlos BenavidezAlaves
Parma,Adrian Benedyczak,296,pl POL,"FW,MF",it Serie A,23,2000,2.4,0,0,0,0,0,0,1,0.0,1,3,1,2,0,0,8,0,Adrian BenedyczakParma
Union Berlin,Laszlo Benes,297,sk SVK,"MF,FW",de Bundesliga,26,1997,6.5,2,2,1,1,0,1,3,33.3,2,5,1,4,3,5,9,0,Laszlo BenesUnion Berlin
Osasuna,Iker Benito,298,es ESP,"FW,MF",es La Liga,21,2002,0.4,0,0,0,0,0,0,1,0.0,1,0,0,0,1,1,2,0,Iker BenitoOsasuna
Milan,Ismael Bennacer,299,dz ALG,MF,it Serie A,26,1997,3.3,5,4,1,3,1,1,7,14.3,6,5,3,2,3,8,1,0,Ismael BennacerMilan
Marseille,Ismael Bennacer,300,dz ALG,MF,fr Ligue 1,26,1997,7.2,21,10,8,12,1,12,18,66.7,6,6,0,6,10,31,2,1,Ismael BennacerMarseille
Lyon,Said Benrahma,301,dz ALG,"FW,MF",fr Ligue 1,28,1995,8.2,9,5,4,4,1,3,10,30.0,7,6,0,6,3,12,2,0,Said BenrahmaLyon
Dortmund,Ramy Bensebaini,302,dz ALG,DF,de Bundesliga,29,1995,22.5,51,25,25,18,8,33,51,64.7,18,42,9,33,33,84,86,1,Ramy BensebainiDortmund
Lille,Nabil Bentaleb,303,dz ALG,MF,fr Ligue 1,29,1994,3.7,4,3,2,0,2,3,7,42.9,4,5,0,5,5,9,7,2,Nabil BentalebLille
Tottenham,Rodrigo Bentancur,304,uy URU,MF,eng Premier League,27,1997,18.3,40,22,19,17,4,19,40,47.5,21,25,8,17,40,80,38,1,Rodrigo BentancurTottenham
Wolves,Daniel Bentley,305,eng ENG,GK,eng Premier League,31,1993,2.0,0,0,0,0,0,0,0,,0,0,0,0,0,0,1,0,Daniel BentleyWolves
Paris S-G,Lucas Beraldo,306,br BRA,DF,fr Ligue 1,20,2003,22.3,38,31,30,8,0,23,37,62.2,14,16,8,8,21,59,63,3,Lucas BeraldoParis S-G
Athletic Club,Yuri Berchiche,307,es ESP,DF,es La Liga,34,1990,22.7,33,21,19,11,3,19,33,57.6,14,25,5,20,27,60,72,3,Yuri BerchicheAthletic Club
Athletic Club,Alex Berenguer,308,es ESP,"FW,MF",es La Liga,29,1995,26.0,32,16,6,16,10,14,31,45.2,17,23,2,21,10,42,18,0,Alex BerenguerAthletic Club
Fulham,Sander Berge,309,no NOR,MF,eng Premier League,26,1998,24.7,50,30,23,23,4,27,39,69.2,12,27,8,19,21,71,38,1,Sander BergeFulham
Tottenham,Lucas Bergvall,310,se SWE,MF,eng Premier League,18,2006,13.5,39,19,14,20,5,17,32,53.1,15,18,8,10,24,63,22,3,Lucas BergvallTottenham
Lecce,Medon Berisha,311,al ALB,MF,it Serie A,20,2003,8.0,12,8,7,3,2,4,8,50.0,4,6,0,6,11,23,5,2,Medon BerishaLecce
Hoffenheim,Mergim Berisha,312,de GER,"FW,MF",de Bundesliga,26,1998,3.7,3,3,1,2,0,0,3,0.0,3,2,1,1,0,3,3,0,Mergim BerishaHoffenheim
Augsburg,Mergim Berisha,313,de GER,FW,de Bundesliga,26,1998,0.4,1,0,0,1,0,1,1,100.0,0,2,1,1,0,1,0,0,Mergim BerishaAugsburg
Parma,Adrian Bernabe,314,es ESP,MF,it Serie A,23,2001,16.1,29,18,16,9,4,14,32,43.8,18,22,9,13,7,36,26,1,Adrian BernabeParma
Barcelona,Marc Bernal,315,es ESP,MF,es La Liga,17,2007,2.7,8,6,2,5,1,7,8,87.5,1,5,1,4,1,9,4,0,Marc BernalBarcelona
Bochum,Bernardo,316,br BRA,DF,de Bundesliga,29,1995,19.8,46,28,32,13,1,27,37,73.0,10,38,17,21,26,72,103,4,BernardoBochum
Villarreal,Juan Bernat,317,es ESP,"DF,MF",es La Liga,31,1993,2.4,9,7,7,1,1,4,5,80.0,1,3,1,2,1,10,4,0,Juan BernatVillarreal
Getafe,Juan Bernat,318,es ESP,"MF,DF",es La Liga,31,1993,7.8,19,13,9,5,5,7,12,58.3,5,9,3,6,2,21,12,0,Juan BernatGetafe
Saint-Etienne,Maxime Bernauer,319,fr FRA,DF,fr Ligue 1,26,1998,8.5,9,9,5,2,2,5,8,62.5,3,7,3,4,5,14,44,1,Maxime BernauerSaint-Etienne
Hellas Verona,Antoine Bernede,320,fr FRA,MF,it Serie A,25,1999,6.6,15,8,4,9,2,10,16,62.5,6,6,1,5,5,20,3,0,Antoine BernedeHellas Verona
Holstein Kiel,Alexander Bernhardsson,321,se SWE,"FW,MF",de Bundesliga,25,1998,14.0,29,15,9,9,11,20,31,64.5,11,14,0,14,5,34,25,0,Alexander BernhardssonHolstein Kiel
Leicester City,Victor Bernth Kristiansen,322,dk DEN,DF,eng Premier League,21,2002,27.6,87,51,56,26,5,49,91,53.8,42,38,15,23,42,129,75,3,Victor Bernth KristiansenLeicester City
Bochum,Matus Bero,323,sk SVK,MF,de Bundesliga,28,1995,28.5,65,35,33,21,11,29,60,48.3,31,37,9,28,17,82,35,1,Matus BeroBochum
Getafe,Juan Berrocal,324,es ESP,DF,es La Liga,25,1999,11.8,14,7,10,4,0,10,14,71.4,4,6,3,3,15,29,59,0,Juan BerrocalGetafe
Montpellier,Dimitry Bertaud,325,cd COD,GK,fr Ligue 1,26,1998,4.0,0,0,0,0,0,0,0,,0,0,0,0,0,0,2,0,Dimitry BertaudMontpellier
Freiburg,Jan-Niklas Beste,326,de GER,"FW,MF",de Bundesliga,25,1999,2.4,2,1,0,1,1,1,7,14.3,6,3,0,3,1,3,7,0,Jan-Niklas BesteFreiburg
Everton,Beto,327,gw GNB,FW,eng Premier League,26,1998,17.0,14,6,2,8,4,5,8,62.5,3,12,2,10,4,18,24,1,BetoEverton
Bologna,Sam Beukema,328,nl NED,DF,it Serie A,25,1998,33.5,54,29,27,24,3,22,41,53.7,19,36,21,15,30,84,111,0,Sam BeukemaBologna
Monza,Alessandro Bianco,329,it ITA,MF,it Serie A,21,2002,28.9,51,28,26,17,8,27,41,65.9,14,40,14,26,22,73,53,4,Alessandro BiancoMonza
Fiorentina,Alessandro Bianco,330,it ITA,MF,it Serie A,21,2002,0.2,0,0,0,0,0,0,1,0.0,1,0,0,0,0,0,0,0,Alessandro BiancoFiorentina
Monaco,Mika Biereth,331,dk DEN,FW,fr Ligue 1,21,2003,13.6,5,5,0,3,2,3,7,42.9,4,11,0,11,4,9,7,0,Mika BierethMonaco
Udinese,Jaka Bijol,332,si SVN,DF,it Serie A,25,1999,32.9,43,25,32,10,1,21,40,52.5,19,38,18,20,38,81,182,1,Jaka BijolUdinese
Stuttgart,El Bilal Toure,333,ml MLI,"FW,MF",de Bundesliga,22,2001,4.0,4,1,1,1,2,3,3,100.0,0,1,0,1,0,4,1,0,El Bilal ToureStuttgart
Bournemouth,Philip Billing,334,dk DEN,MF,eng Premier League,28,1996,2.0,14,5,7,6,1,3,4,75.0,1,3,0,3,5,19,2,0,Philip BillingBournemouth
Napoli,Philip Billing,335,dk DEN,MF,it Serie A,28,1996,2.2,9,6,4,4,1,1,4,25.0,3,4,1,3,4,13,6,0,Philip BillingNapoli
Torino,Cristiano Biraghi,336,it ITA,DF,it Serie A,31,1992,12.9,16,10,9,3,4,11,18,61.1,7,15,4,11,8,24,44,0,Cristiano BiraghiTorino
Fiorentina,Cristiano Biraghi,337,it ITA,DF,it Serie A,31,1992,4.8,4,4,1,3,0,2,7,28.6,5,2,0,2,4,8,11,0,Cristiano BiraghiFiorentina
Monza,Samuele Birindelli,338,it ITA,"DF,MF",it Serie A,25,1999,16.3,22,15,13,4,5,6,14,42.9,8,15,2,13,10,32,34,2,Samuele BirindelliMonza
Hoffenheim,Tom Bischof,339,de GER,"MF,FW",de Bundesliga,19,2005,28.4,95,53,36,45,14,40,77,51.9,37,66,11,55,30,125,53,1,Tom BischofHoffenheim
Tottenham,Yves Bissouma,340,ml MLI,MF,eng Premier League,27,1996,15.6,49,31,20,25,4,19,34,55.9,15,11,6,5,18,67,40,4,Yves BissoumaTottenham
Werder Bremen,Leonardo Bittencourt,341,de GER,MF,de Bundesliga,30,1993,10.9,25,9,15,7,3,6,18,33.3,12,8,0,8,15,40,11,0,Leonardo BittencourtWerder Bremen
Angers,Emmanuel Biumla,342,fr FRA,DF,fr Ligue 1,19,2005,14.8,19,12,14,5,0,12,18,66.7,6,18,8,10,8,27,84,1,Emmanuel BiumlaAngers
Brest,Marco Bizot,343,nl NED,GK,fr Ligue 1,33,1991,32.0,2,1,2,0,0,1,2,50.0,1,0,0,0,0,2,33,0,Marco BizotBrest
Venezia,Bjarki Bjarkason,344,is ISL,"DF,MF",it Serie A,24,2000,1.8,3,2,2,1,0,1,2,50.0,1,1,0,1,2,5,4,0,Bjarki BjarkasonVenezia
Alaves,Antonio Blanco,345,es ESP,MF,es La Liga,24,2000,30.3,67,40,23,37,7,32,83,38.6,51,30,7,23,42,109,48,1,Antonio BlancoAlaves
Rennes,Ludovic Blas,346,fr FRA,"MF,FW",fr Ligue 1,26,1997,25.5,38,25,9,12,17,23,42,54.8,19,16,2,14,13,51,11,0,Ludovic BlasRennes
Girona,Daley Blind,347,nl NED,DF,es La Liga,34,1990,30.9,49,27,26,19,4,31,48,64.6,17,32,9,23,32,81,94,2,Daley BlindGirona
Bochum,Myron Boadu,348,nl NED,FW,de Bundesliga,23,2001,11.6,2,1,0,0,2,1,5,20.0,4,3,0,3,1,3,4,0,Myron BoaduBochum
Saint-Etienne,Augustine Boakye,349,gh GHA,"FW,MF",fr Ligue 1,23,2000,8.1,7,3,3,4,0,3,11,27.3,8,5,0,5,6,13,4,0,Augustine BoakyeSaint-Etienne
Manchester City,Oscar Bobb,350,no NOR,FW,eng Premier League,21,2003,0.2,0,0,0,0,0,0,0,,0,0,0,0,0,0,0,0,Oscar BobbManchester City
Le Havre,Matheo Bodmer,351,fr FRA,MF,fr Ligue 1,20,2004,0.1,0,0,0,0,0,0,0,,0,0,0,0,0,0,1,0,Matheo BodmerLe Havre
Bayern Munich,Sacha Boey,352,fr FRA,DF,de Bundesliga,23,2000,6.6,20,5,6,6,8,13,18,72.2,5,6,0,6,2,22,14,0,Sacha BoeyBayern Munich
Nice,Jeremie Boga,353,ci CIV,"MF,FW",fr Ligue 1,27,1997,11.7,10,5,2,5,3,4,8,50.0,4,13,0,13,3,13,2,1,Jeremie BogaNice
Aston Villa,Lamare Bogarde,354,nl NED,"DF,MF",eng Premier League,20,2004,5.3,14,6,6,6,2,10,16,62.5,6,5,3,2,1,15,13,0,Lamare BogardeAston Villa
Genoa,Emil Bohinen,355,no NOR,MF,it Serie A,25,1999,1.8,4,4,3,0,1,2,5,40.0,3,2,0,2,1,5,6,0,Emil BohinenGenoa
Athletic Club,Adama Boiro,356,es ESP,"DF,FW",es La Liga,22,2002,12.2,20,11,11,7,2,10,15,66.7,5,10,3,7,12,32,27,1,Adama BoiroAthletic Club
Nott'ham Forest,Willy Boly,357,ci CIV,DF,eng Premier League,33,1991,1.7,6,1,5,1,0,4,4,100.0,0,4,2,2,3,9,12,0,Willy BolyNott'ham Forest
Nice,Moise Bombito,358,ca CAN,DF,fr Ligue 1,24,2000,24.4,37,25,22,12,3,24,35,68.6,11,35,19,16,18,55,121,7,Moise BombitoNice
Monza,Warren Bondo,359,fr FRA,MF,it Serie A,20,2003,18.0,35,24,19,12,4,13,19,68.4,6,16,6,10,5,40,8,4,Warren BondoMonza
Milan,Warren Bondo,360,fr FRA,MF,it Serie A,20,2003,1.8,5,3,4,1,0,3,3,100.0,0,1,0,1,0,5,2,0,Warren BondoMilan
Leverkusen,Victor Boniface,361,ng NGA,FW,de Bundesliga,23,2000,11.2,5,4,0,3,2,3,4,75.0,1,1,0,1,0,5,5,0,Victor BonifaceLeverkusen
Lecce,Kevin Bonifazi,362,it ITA,DF,it Serie A,28,1996,0.7,1,1,1,0,0,1,1,100.0,0,1,1,0,2,3,3,0,Kevin BonifaziLecce
Parma,Ange-Yoan Bonny,363,fr FRA,FW,it Serie A,20,2003,28.1,34,16,4,23,7,8,14,57.1,6,17,2,15,3,37,17,0,Ange-Yoan BonnyParma
Wolfsburg,Sebastiaan Bornauw,364,be BEL,DF,de Bundesliga,25,1999,8.8,9,6,4,4,1,4,8,50.0,4,14,12,2,12,21,36,0,Sebastiaan BornauwWolfsburg
Newcastle Utd,Sven Botman,365,nl NED,DF,eng Premier League,24,2000,4.6,12,9,6,5,1,7,9,77.8,2,5,4,1,5,17,25,1,Sven BotmanNewcastle Utd
Monaco,Saimon Bouabre,366,fr FRA,"MF,FW",fr Ligue 1,18,2006,1.1,1,0,0,1,0,0,3,0.0,3,1,0,1,0,1,0,0,Saimon BouabreMonaco
Lille,Ayyoub Bouaddi,367,fr FRA,MF,fr Ligue 1,16,2007,12.8,50,31,21,21,8,19,32,59.4,13,12,3,9,10,60,12,1,Ayyoub BouaddiLille
Nice,Badredine Bouanani,368,dz ALG,"MF,FW",fr Ligue 1,19,2004,12.2,11,4,4,4,3,6,18,33.3,12,16,3,13,11,22,4,0,Badredine BouananiNice
Saint-Etienne,Benjamin Bouchouari,369,ma MAR,MF,fr Ligue 1,22,2001,19.7,33,27,15,13,5,16,46,34.8,30,21,1,20,17,50,15,2,Benjamin BouchouariSaint-Etienne
Nice,Hicham Boudaoui,370,dz ALG,MF,fr Ligue 1,24,1999,27.1,76,52,28,37,11,31,53,58.5,22,40,11,29,22,98,45,1,Hicham BoudaouiNice
St. Pauli,Carlo Boukhalfa,371,ma MAR,MF,de Bundesliga,25,1999,18.3,26,11,7,17,2,7,19,36.8,12,22,3,19,12,38,25,1,Carlo BoukhalfaSt. Pauli
Brest,Justin Bourgault,372,fr FRA,DF,fr Ligue 1,18,2005,1.4,2,1,1,1,0,0,0,,0,0,0,0,0,2,1,0,Justin BourgaultBrest
Rennes,Benjamin Bourigeaud,373,fr FRA,MF,fr Ligue 1,30,1994,0.9,1,0,0,1,0,0,2,0.0,2,2,1,1,2,3,1,0,Benjamin BourigeaudRennes
Fiorentina,Edoardo Bove,374,it ITA,"MF,FW",it Serie A,22,2002,9.3,24,17,7,14,3,14,28,50.0,14,12,0,12,6,30,8,0,Edoardo BoveFiorentina
West Ham,Jarrod Bowen,375,eng ENG,"FW,MF",eng Premier League,27,1996,33.0,41,26,13,12,16,19,40,47.5,21,22,4,18,16,57,25,0,Jarrod BowenWest Ham
Osasuna,Enzo Boyomo,376,cm CMR,DF,es La Liga,22,2001,33.2,68,43,46,18,4,30,39,76.9,9,34,19,15,44,112,137,3,Enzo BoyomoOsasuna
Valladolid,Enzo Boyomo,377,cm CMR,DF,es La Liga,22,2001,3.0,6,2,4,2,0,3,3,100.0,0,4,3,1,1,7,7,0,Enzo BoyomoValladolid
Hellas Verona,Domagoj Bradaric,378,hr CRO,DF,it Serie A,24,1999,21.5,36,28,21,11,4,18,29,62.1,11,17,4,13,15,51,49,1,Domagoj BradaricHellas Verona
Liverpool,Conor Bradley,379,nir NIR,DF,eng Premier League,21,2003,8.4,14,10,7,5,2,11,22,50.0,11,9,2,7,4,18,31,0,Conor BradleyLiverpool
Nice,Bilal Brahimi,380,dz ALG,MF,fr Ligue 1,24,2000,0.8,0,0,0,0,0,0,0,,0,1,0,1,0,0,2,0,Bilal BrahimiNice
Dortmund,Julian Brandt,381,de GER,MF,de Bundesliga,28,1996,25.6,26,11,13,8,5,15,43,34.9,28,17,0,17,14,40,13,1,Julian BrandtDortmund
Everton,Jarrad Branthwaite,382,eng ENG,DF,eng Premier League,22,2002,27.9,36,20,26,10,0,20,28,71.4,8,31,23,8,27,63,191,4,Jarrad BranthwaiteEverton
Leganes,Darko Brasanac,383,rs SRB,MF,es La Liga,32,1992,18.0,26,11,5,15,6,9,17,52.9,8,24,11,13,16,42,34,0,Darko BrasanacLeganes
Marseille,Lilian Brassier,384,fr FRA,DF,fr Ligue 1,24,1999,8.7,8,6,8,0,0,5,6,83.3,1,8,3,5,9,17,28,2,Lilian BrassierMarseille
Rennes,Lilian Brassier,385,fr FRA,DF,fr Ligue 1,24,1999,13.7,15,12,11,4,0,9,11,81.8,2,17,10,7,22,37,62,1,Lilian BrassierRennes
Como,Matthias Braunoder,386,at AUT,MF,it Serie A,22,2002,3.0,10,4,6,3,1,7,11,63.6,4,3,0,3,2,12,4,1,Matthias BraunoderComo
Udinese,Iker Bravo,387,es ESP,"FW,MF",it Serie A,19,2005,7.6,10,6,3,5,2,5,9,55.6,4,4,1,3,1,11,4,0,Iker BravoUdinese
Southampton,James Bree,388,eng ENG,DF,eng Premier League,26,1997,11.9,19,14,8,10,1,10,25,40.0,15,10,3,7,9,28,29,0,James BreeSouthampton
Augsburg,Tim Breithaupt,389,de GER,MF,de Bundesliga,22,2002,1.3,1,1,0,1,0,0,4,0.0,4,1,0,1,2,3,0,0,Tim BreithauptAugsburg
Juventus,Gleison Bremer,390,br BRA,DF,it Serie A,27,1997,6.0,15,7,9,5,1,4,5,80.0,1,15,11,4,6,21,16,0,Gleison BremerJuventus
Udinese,Brenner,391,br BRA,"MF,FW",it Serie A,24,2000,4.3,6,4,2,3,1,3,8,37.5,5,4,0,4,1,7,6,0,BrennerUdinese
Southampton,Ben Brereton,392,cl CHI,FW,eng Premier League,25,1999,5.0,3,2,0,2,1,1,9,11.1,8,2,1,1,0,3,4,0,Ben BreretonSouthampton
Atalanta,Marco Brescianini,393,it ITA,MF,it Serie A,24,2000,11.0,18,11,5,9,4,8,10,80.0,2,15,2,13,2,20,6,0,Marco BrescianiniAtalanta
Heidenheim,Maximilian Breunig,394,de GER,"FW,MF",de Bundesliga,23,2000,3.9,4,3,1,2,1,3,6,50.0,3,9,2,7,1,5,3,0,Maximilian BreunigHeidenheim
Saint-Etienne,Anthony Briancon,395,fr FRA,DF,fr Ligue 1,29,1994,0.0,0,0,0,0,0,0,0,,0,0,0,0,0,0,0,0,Anthony BrianconSaint-Etienne
Ipswich Town,Nathan Broadhead,396,wls WAL,"MF,FW",eng Premier League,26,1998,7.8,9,4,3,6,0,3,12,25.0,9,8,1,7,4,13,5,0,Nathan BroadheadIpswich Town
Everton,Armando Broja,397,al ALB,FW,eng Premier League,22,2001,3.7,3,1,1,1,1,0,0,,0,3,0,3,1,4,4,0,Armando BrojaEverton
Bournemouth,David Brooks,398,wls WAL,"FW,MF",eng Premier League,27,1997,10.7,14,6,2,8,4,2,16,12.5,14,18,2,16,5,19,9,1,David BrooksBournemouth
Monza,Arvid Brorsson,399,se SWE,DF,it Serie A,25,1999,4.0,4,3,2,2,0,2,5,40.0,3,9,8,1,2,6,35,1,Arvid BrorssonMonza
Bochum,Moritz Broschinski,400,de GER,"FW,MF",de Bundesliga,23,2000,15.4,19,14,6,6,7,6,15,40.0,9,18,0,18,1,20,18,0,Moritz BroschinskiBochum
Eint Frankfurt,Nathaniel Brown,401,de GER,"DF,MF",de Bundesliga,21,2003,21.6,71,42,39,18,14,44,55,80.0,11,30,0,30,15,86,55,1,Nathaniel BrownEint Frankfurt
Hoffenheim,Jacob Bruun Larsen,402,dk DEN,"FW,MF",de Bundesliga,25,1998,4.4,4,3,1,2,1,3,8,37.5,5,5,1,4,1,5,2,0,Jacob Bruun LarsenHoffenheim
Stuttgart,Jacob Bruun Larsen,403,dk DEN,"MF,FW",de Bundesliga,25,1998,4.6,1,1,1,0,0,0,2,0.0,2,7,0,7,1,2,4,1,Jacob Bruun LarsenStuttgart
Inter,Tajon Buchanan,404,ca CAN,"DF,FW",it Serie A,25,1999,1.1,3,0,2,0,1,1,2,50.0,1,0,0,0,0,3,3,0,Tajon BuchananInter
Villarreal,Tajon Buchanan,405,ca CAN,MF,es La Liga,25,1999,4.6,10,5,6,4,0,6,9,66.7,3,6,0,6,1,11,1,0,Tajon BuchananVillarreal
Osasuna,Ante Budimir,406,hr CRO,FW,es La Liga,33,1991,32.8,20,9,3,11,6,3,13,23.1,10,19,4,15,2,22,26,0,Ante BudimirOsasuna
Aston Villa,Emi Buendia,407,ar ARG,"MF,FW",eng Premier League,27,1996,1.1,6,6,3,2,1,0,5,0.0,5,5,1,4,0,6,2,0,Emi BuendiaAston Villa
Leverkusen,Emi Buendia,408,ar ARG,MF,de Bundesliga,27,1996,2.9,6,5,1,4,1,5,8,62.5,3,6,0,6,0,6,0,0,Emi BuendiaLeverkusen
Sevilla,Manu Bueno,409,es ESP,"MF,FW",es La Liga,20,2004,1.6,4,3,0,1,3,1,2,50.0,1,0,0,0,0,4,2,0,Manu BuenoSevilla
Wolves,Santiago Bueno,410,uy URU,DF,eng Premier League,25,1998,18.7,41,21,22,18,1,17,22,77.3,5,36,21,15,15,56,70,0,Santiago BuenoWolves
Athletic Club,Endika Bujan,411,es ESP,FW,es La Liga,21,2003,0.1,0,0,0,0,0,0,1,0.0,1,0,0,0,0,0,0,0,Endika BujanAthletic Club
Hoffenheim,Marius Bulter,412,de GER,"FW,DF",de Bundesliga,31,1993,19.2,13,10,5,6,2,9,17,52.9,8,10,3,7,4,17,14,1,Marius BulterHoffenheim
Leicester City,Facundo Buonanotte,413,ar ARG,"FW,MF",eng Premier League,19,2004,16.9,53,32,17,22,14,21,67,31.3,46,34,6,28,12,65,14,0,Facundo BuonanotteLeicester City
Napoli,Alessandro Buongiorno,414,it ITA,DF,it Serie A,25,1999,21.4,39,23,26,12,1,24,32,75.0,8,30,18,12,35,74,73,2,Alessandro BuongiornoNapoli
Ipswich Town,Cameron Burgess,415,au AUS,DF,eng Premier League,28,1995,17.1,17,12,14,3,0,9,11,81.8,2,20,15,5,14,31,128,3,Cameron BurgessIpswich Town
Mainz 05,Jonathan Burkardt,416,de GER,FW,de Bundesliga,24,2000,23.4,15,8,1,7,7,6,10,60.0,4,11,1,10,1,16,14,0,Jonathan BurkardtMainz 05
Werder Bremen,Oliver Burke,417,sct SCO,FW,de Bundesliga,27,1997,10.1,11,4,5,1,5,4,6,66.7,2,20,0,20,2,13,6,0,Oliver BurkeWerder Bremen
Newcastle Utd,Dan Burn,418,eng ENG,DF,eng Premier League,32,1992,37.0,39,24,22,15,2,20,36,55.6,16,36,26,10,27,66,197,4,Dan BurnNewcastle Utd
Lecce,Rares-Catalin Burnete,419,ro ROU,FW,it Serie A,20,2004,0.3,0,0,0,0,0,0,1,0.0,1,0,0,0,0,0,0,0,Rares-Catalin BurneteLecce
Ipswich Town,Wes Burns,420,wls WAL,"FW,DF",eng Premier League,29,1994,10.3,13,11,1,9,3,4,10,40.0,6,7,2,5,10,23,13,2,Wes BurnsIpswich Town
Heidenheim,Marnon Busch,421,de GER,"DF,MF",de Bundesliga,29,1994,15.5,26,17,19,7,0,23,32,71.9,9,23,10,13,13,39,65,5,Marnon BuschHeidenheim
Venezia,Gianluca Busio,422,us USA,MF,it Serie A,22,2002,28.0,46,31,24,12,10,20,47,42.6,27,36,8,28,19,65,52,0,Gianluca BusioVenezia
Reims,Aurelio Buta,423,pt POR,DF,fr Ligue 1,27,1997,21.9,37,24,22,11,4,21,42,50.0,21,19,5,14,22,59,59,0,Aurelio ButaReims
Como,Jean Butez,424,fr FRA,GK,it Serie A,29,1995,18.5,0,0,0,0,0,0,2,0.0,2,0,0,0,0,0,18,1,Jean ButezComo
Arsenal,Nathan Butler-Oyedeji,425,eng ENG,FW,eng Premier League,21,2003,0.1,0,0,0,0,0,0,0,,0,0,0,0,0,0,0,0,Nathan Butler-OyedejiArsenal
Nice,Marcin Bulka,426,pl POL,GK,fr Ligue 1,24,1999,34.0,0,0,0,0,0,0,1,0.0,1,0,0,0,0,0,16,6,Marcin BulkaNice
Villarreal,Pau Cabanes,427,es ESP,"MF,FW",es La Liga,19,2005,1.8,4,4,0,3,1,3,4,75.0,1,5,0,5,3,7,2,1,Pau CabanesVillarreal
Alaves,Pau Cabanes,428,es ESP,"MF,FW",es La Liga,19,2005,2.1,8,2,4,3,1,6,13,46.2,7,2,0,2,0,8,1,0,Pau CabanesAlaves
Lille,Remy Cabella,429,fr FRA,"FW,MF",fr Ligue 1,34,1990,11.2,39,19,16,13,10,19,33,57.6,14,10,1,9,8,47,5,0,Remy CabellaLille
Espanyol,Leandro Cabrera,430,uy URU,DF,es La Liga,33,1991,31.9,40,23,29,8,3,19,33,57.6,14,35,25,10,30,70,199,2,Leandro CabreraEspanyol
Empoli,Liberato Cacace,431,nz NZL,"MF,DF",it Serie A,23,2000,24.8,37,25,20,13,4,22,31,71.0,9,26,9,17,22,59,59,0,Liberato CacaceEmpoli
Torino,Alessio Cacciamani,432,it ITA,"MF,DF",it Serie A,17,2007,0.3,0,0,0,0,0,0,0,,0,0,0,0,1,1,0,0,Alessio CacciamaniTorino
Mainz 05,Anthony Caci,433,fr FRA,DF,de Bundesliga,27,1997,29.8,60,40,23,25,12,28,44,63.6,16,33,8,25,27,87,47,2,Anthony CaciMainz 05
Saint-Etienne,Mathieu Cafaro,434,fr FRA,"MF,FW",fr Ligue 1,27,1997,8.1,10,7,4,4,2,4,15,26.7,11,7,1,6,7,17,3,0,Mathieu CafaroSaint-Etienne
Chelsea,Moises Caicedo,435,ec ECU,"MF,DF",eng Premier League,22,2001,37.2,114,73,44,54,16,54,86,62.8,32,49,10,39,49,163,60,1,Moises CaicedoChelsea
Fulham,Tom Cairney,436,sct SCO,MF,eng Premier League,33,1991,7.0,13,5,5,2,6,4,7,57.1,3,7,1,6,4,17,3,1,Tom CairneyFulham
Ipswich Town,Jens Cajuste,437,se SWE,MF,eng Premier League,24,1999,21.8,44,22,19,23,2,21,49,42.9,28,25,10,15,28,72,33,2,Jens CajusteIpswich Town
Bologna,Davide Calabria,438,it ITA,DF,it Serie A,27,1996,7.0,12,8,5,5,2,5,12,41.7,7,4,0,4,3,15,22,1,Davide CalabriaBologna
Milan,Davide Calabria,439,it ITA,DF,it Serie A,27,1996,3.5,10,7,10,0,0,4,7,57.1,3,1,0,1,8,18,8,0,Davide CalabriaMilan
Arsenal,Riccardo Calafiori,440,it ITA,DF,eng Premier League,22,2002,10.9,27,19,15,10,2,18,29,62.1,11,12,6,6,9,36,25,0,Riccardo CalafioriArsenal
Monza,Luca Caldirola,441,it ITA,DF,it Serie A,33,1991,9.7,11,7,8,3,0,4,7,57.1,3,9,6,3,11,22,43,1,Luca CaldirolaMonza
Espanyol,Fernando Calero,442,es ESP,"DF,MF",es La Liga,28,1995,7.9,18,10,13,4,1,8,12,66.7,4,16,9,7,16,34,50,1,Fernando CaleroEspanyol
Lyon,Duje Caleta-Car,443,hr CRO,DF,fr Ligue 1,27,1996,17.6,20,12,11,9,0,10,19,52.6,9,33,25,8,17,37,97,2,Duje Caleta-CarLyon
Inter,Hakan Calhanoglu,444,tr TUR,MF,it Serie A,30,1994,20.9,43,22,7,23,13,21,36,58.3,15,17,8,9,17,60,24,0,Hakan CalhanogluInter
Everton,Dominic Calvert-Lewin,445,eng ENG,FW,eng Premier League,27,1997,17.9,9,7,1,4,4,2,6,33.3,4,7,2,5,7,16,23,0,Dominic Calvert-LewinEverton
Parma,Drissa Camara,446,ci CIV,"MF,FW",it Serie A,22,2002,5.0,9,7,2,6,1,1,10,10.0,9,8,0,8,3,12,1,0,Drissa CamaraParma
Nice,Issiaga Camara,447,gn GUI,MF,fr Ligue 1,19,2005,0.2,2,1,0,2,0,0,1,0.0,1,0,0,0,3,5,0,0,Issiaga CamaraNice
Monaco,Lamine Camara,448,sn SEN,MF,fr Ligue 1,20,2004,22.8,66,41,22,34,10,26,48,54.2,22,30,4,26,31,97,32,1,Lamine CamaraMonaco
Brest,Mahdi Camara,449,fr FRA,"MF,FW",fr Ligue 1,26,1998,29.5,71,40,16,38,17,24,46,52.2,22,40,5,35,33,104,29,0,Mahdi CamaraBrest
Angers,Ousmane Camara,450,fr FRA,DF,fr Ligue 1,21,2003,2.8,4,3,3,1,0,1,2,50.0,1,1,1,0,0,4,18,0,Ousmane CamaraAngers
Milan,Francesco Camarda,451,it ITA,"FW,MF",it Serie A,16,2008,2.3,5,2,0,2,3,2,6,33.3,4,2,1,1,0,5,3,0,Francesco CamardaMilan
Real Madrid,Eduardo Camavinga,452,fr FRA,"MF,DF",es La Liga,21,2002,12.2,42,26,23,16,3,19,33,57.6,14,24,8,16,18,60,23,0,Eduardo CamavingaReal Madrid
Bologna,Nicolo Cambiaghi,453,it ITA,FW,it Serie A,23,2000,6.9,16,10,6,7,3,5,10,50.0,5,9,0,9,2,18,2,0,Nicolo CambiaghiBologna
Juventus,Andrea Cambiaso,454,it ITA,"DF,FW",it Serie A,24,2000,24.7,46,30,27,13,6,27,44,61.4,17,24,4,20,16,62,34,5,Andrea CambiasoJuventus
Brest,Axel Camblan,455,fr FRA,"MF,FW",fr Ligue 1,20,2003,0.3,1,1,0,0,1,1,2,50.0,1,1,0,1,0,1,0,0,Axel CamblanBrest
Rayo Vallecano,Sergio Camello,456,es ESP,FW,es La Liga,23,2001,12.6,9,3,2,5,2,4,6,66.7,2,8,1,7,4,13,16,0,Sergio CamelloRayo Vallecano
Las Palmas,Jose Campana,457,es ESP,MF,es La Liga,31,1993,13.2,21,16,8,11,2,11,20,55.0,9,9,1,8,19,40,19,2,Jose CampanaLas Palmas
Empoli,Thomas Campaniello,458,it ITA,FW,it Serie A,16,2008,0.3,0,0,0,0,0,0,2,0.0,2,0,0,0,0,0,0,0,Thomas CampanielloEmpoli
Dortmund,Cole Campbell,459,us USA,"MF,FW",de Bundesliga,18,2006,0.2,0,0,0,0,0,0,0,,0,0,0,0,0,0,1,0,Cole CampbellDortmund
Dortmund,Emre Can,460,de GER,"DF,MF",de Bundesliga,30,1994,23.4,50,28,30,16,4,18,36,50.0,18,31,17,14,20,70,89,3,Emre CanDortmund
Athletic Club,Peio Canales,461,es ESP,"MF,FW",es La Liga,19,2005,2.9,3,2,0,1,2,1,1,100.0,0,3,0,3,2,5,2,0,Peio CanalesAthletic Club
Parma,Matteo Cancellieri,462,it ITA,"FW,MF",it Serie A,22,2002,15.8,26,16,15,9,2,11,32,34.4,21,15,1,14,13,39,30,0,Matteo CancellieriParma
Venezia,Fali Cande,463,gw GNB,DF,it Serie A,26,1998,17.0,25,19,14,10,1,16,23,69.6,7,21,15,6,15,40,90,2,Fali CandeVenezia
Venezia,Antonio Candela,464,it ITA,DF,it Serie A,24,2000,11.2,31,21,13,11,7,18,26,69.2,8,7,5,2,8,39,22,2,Antonio CandelaVenezia
Valladolid,Antonio Candela,465,it ITA,DF,es La Liga,24,2000,10.1,9,6,6,2,1,4,11,36.4,7,11,6,5,6,15,33,0,Antonio CandelaValladolid
Valencia,Sergi Canos,466,es ESP,"MF,FW",es La Liga,27,1997,4.1,11,7,3,4,4,4,10,40.0,6,6,1,5,5,16,5,0,Sergi CanosValencia
Toulouse,Jaydee Canvot,467,fr FRA,"DF,MF",fr Ligue 1,18,2006,12.3,23,11,16,5,2,12,18,66.7,6,10,2,8,11,34,54,1,Jaydee CanvotToulouse
Angers,Pierrick Capelle,468,fr FRA,MF,fr Ligue 1,37,1987,5.4,24,17,10,9,5,9,18,50.0,9,4,1,3,11,35,5,1,Pierrick CapelleAngers
Monza,Gianluca Caprari,469,it ITA,"MF,FW",it Serie A,31,1993,18.3,19,11,8,8,3,7,14,50.0,7,14,0,14,8,27,2,1,Gianluca CaprariMonza
Cagliari,Elia Caprile,470,it ITA,GK,it Serie A,22,2001,18.0,1,0,1,0,0,0,2,0.0,2,0,0,0,0,1,9,1,Elia CaprileCagliari
Napoli,Elia Caprile,471,it ITA,GK,it Serie A,22,2001,3.6,0,0,0,0,0,0,0,,0,0,0,0,0,0,2,0,Elia CaprileNapoli
Lens,Gabin Capuano,472,fr FRA,FW,fr Ligue 1,18,2006,0.1,0,0,0,0,0,0,0,,0,0,0,0,0,0,0,0,Gabin CapuanoLens
Empoli,Francesco Caputo,473,it ITA,FW,it Serie A,36,1987,0.1,0,0,0,0,0,0,0,,0,0,0,0,0,0,0,0,Francesco CaputoEmpoli
Como,Maxence Caqueret,474,fr FRA,MF,it Serie A,24,2000,12.1,36,21,14,18,4,20,38,52.6,18,15,1,14,7,43,4,1,Maxence CaqueretComo
Lyon,Maxence Caqueret,475,fr FRA,MF,fr Ligue 1,24,2000,6.4,21,11,5,11,5,4,22,18.2,18,12,2,10,7,28,2,0,Maxence CaqueretLyon
Montpellier,Simon Cara,476,fr FRA,"MF,FW",fr Ligue 1,19,2005,0.1,0,0,0,0,0,0,0,,0,0,0,0,0,0,0,0,Simon CaraMontpellier
Monza,Andrea Carboni,477,it ITA,DF,it Serie A,23,2001,24.3,60,35,39,17,4,35,53,66.0,18,31,16,15,27,87,106,4,Andrea CarboniMonza
Venezia,Franco Carboni,478,it ITA,DF,it Serie A,21,2003,2.5,5,3,5,0,0,5,8,62.5,3,1,1,0,0,5,11,0,Franco CarboniVenezia
Marseille,Valentin Carboni,479,ar ARG,"MF,FW",fr Ligue 1,19,2005,1.1,2,2,0,1,1,0,1,0.0,1,1,0,1,1,3,1,0,Valentin CarboniMarseille
Rayo Vallecano,Dani Cardenas,480,es ESP,GK,es La Liga,27,1997,6.0,0,0,0,0,0,0,0,,0,0,0,0,0,0,3,0,Dani CardenasRayo Vallecano
Espanyol,Irvin Cardona,481,fr FRA,"FW,MF",es La Liga,26,1997,6.7,8,5,2,4,2,6,16,37.5,10,5,1,4,4,12,10,0,Irvin CardonaEspanyol
Saint-Etienne,Irvin Cardona,482,fr FRA,FW,fr Ligue 1,26,1997,11.8,6,5,3,3,0,2,14,14.3,12,16,3,13,4,10,6,2,Irvin CardonaSaint-Etienne
Las Palmas,Marc Cardona,483,es ESP,"FW,DF",es La Liga,29,1995,1.5,4,2,1,3,0,0,1,0.0,1,0,0,0,0,4,0,0,Marc CardonaLas Palmas
Villarreal,Sergi Cardona,484,es ESP,DF,es La Liga,25,1999,32.7,71,48,44,20,7,49,79,62.0,30,52,7,45,40,111,122,1,Sergi CardonaVillarreal
Betis,Johnny Cardoso,485,us USA,MF,es La Liga,22,2001,23.8,55,31,12,35,8,20,52,38.5,32,27,12,15,48,103,64,1,Johnny CardosoBetis
Gladbach,Tiago Cardoso,486,lu LUX,GK,de Bundesliga,18,2006,4.2,1,0,1,0,0,1,1,100.0,0,0,0,0,0,1,2,2,Tiago CardosoGladbach
Nantes,Patrik Carlgren,487,se SWE,GK,fr Ligue 1,32,1992,4.6,0,0,0,0,0,0,0,,0,0,0,0,0,0,0,0,Patrik CarlgrenNantes
Aston Villa,Diego Carlos,488,br BRA,DF,eng Premier League,31,1993,9.2,8,3,6,1,1,4,6,66.7,2,13,7,6,5,13,36,2,Diego CarlosAston Villa
Las Palmas,Jose Carlos Gonzalez,489,es ESP,DF,es La Liga,18,2006,0.1,0,0,0,0,0,0,0,,0,0,0,0,0,0,0,0,Jose Carlos GonzalezLas Palmas
Sevilla,Carmona,490,es ESP,DF,es La Liga,22,2002,32.7,83,59,53,21,9,41,77,53.2,36,37,11,26,68,151,92,3,CarmonaSevilla
Atalanta,Marco Carnesecchi,491,it ITA,GK,it Serie A,24,2000,34.0,0,0,0,0,0,0,0,,0,1,0,1,0,0,26,2,Marco CarnesecchiAtalanta
Celta Vigo,Sergio Carreira,492,es ESP,"MF,DF",es La Liga,23,2000,18.4,28,16,16,6,6,14,26,53.8,12,20,2,18,17,45,37,0,Sergio CarreiraCelta Vigo
Real Madrid,Dani Carvajal,493,es ESP,DF,es La Liga,32,1992,6.8,12,8,7,3,2,9,12,75.0,3,8,3,5,10,22,19,1,Dani CarvajalReal Madrid
Brentford,Fabio Carvalho,494,pt POR,"FW,MF",eng Premier League,21,2002,5.1,13,9,4,4,5,6,13,46.2,7,6,1,5,3,16,2,0,Fabio CarvalhoBrentford
Betis,William Carvalho,495,pt POR,MF,es La Liga,32,1992,5.4,9,6,3,6,0,4,6,66.7,2,6,2,4,3,12,6,0,William CarvalhoBetis
Torino,Cesare Casadei,496,it ITA,MF,it Serie A,21,2003,11.3,12,5,4,8,0,5,10,50.0,5,4,2,2,5,17,26,0,Cesare CasadeiTorino
Barcelona,Marc Casado,497,es ESP,MF,es La Liga,20,2003,17.9,44,25,7,30,7,20,41,48.8,21,20,5,15,22,66,22,1,Marc CasadoBarcelona
Bologna,Nicolo Casale,498,it ITA,DF,it Serie A,26,1998,10.0,11,5,4,6,1,5,10,50.0,5,15,7,8,17,28,43,3,Nicolo CasaleBologna
Lazio,Nicolo Casale,499,it ITA,DF,it Serie A,26,1998,1.5,5,3,4,1,0,0,0,,0,4,3,1,1,6,2,0,Nicolo CasaleLazio
Manchester Utd,Casemiro,500,br BRA,MF,eng Premier League,32,1992,16.6,83,50,50,23,10,45,74,60.8,29,39,10,29,14,97,51,3,CasemiroManchester Utd
West Ham,Kaelan Casey,501,eng ENG,DF,eng Premier League,19,2004,0.0,0,0,0,0,0,0,0,,0,0,0,0,0,0,1,0,Kaelan CaseyWest Ham
Aston Villa,Matty Cash,502,pl POL,DF,eng Premier League,26,1997,23.0,56,32,29,21,6,31,43,72.1,12,22,8,14,23,79,70,2,Matty CashAston Villa
Brighton,Eiran Cashin,503,ie IRL,DF,eng Premier League,22,2001,0.2,0,0,0,0,0,0,1,0.0,1,0,0,0,0,0,2,0,Eiran CashinBrighton
Le Havre,Josue Casimir,504,fr FRA,"FW,MF",fr Ligue 1,22,2001,22.2,37,26,15,15,7,9,18,50.0,9,19,0,19,7,44,35,1,Josue CasimirLe Havre
Atalanta,Federico Cassa,505,it ITA,"MF,FW",it Serie A,18,2006,0.2,0,0,0,0,0,0,0,,0,1,0,1,0,0,0,0,Federico CassaAtalanta
Toulouse,Cristian Casseres Jr.,506,ve VEN,MF,fr Ligue 1,24,2000,30.0,96,61,41,43,12,46,88,52.3,42,35,9,26,42,138,36,1,Cristian Casseres Jr.Toulouse
Fulham,Timothy Castagne,507,be BEL,DF,eng Premier League,28,1995,18.3,46,29,28,15,3,26,45,57.8,19,15,6,9,22,68,83,0,Timothy CastagneFulham
Lazio,Valentin Castellanos,508,ar ARG,FW,it Serie A,25,1998,26.5,13,6,2,4,7,1,10,10.0,9,18,2,16,6,19,25,0,Valentin CastellanosLazio
Nantes,Jean-Charles Castelletto,509,cm CMR,"DF,MF",fr Ligue 1,29,1995,29.1,34,17,17,15,2,17,27,63.0,10,27,18,9,25,59,151,0,Jean-Charles CastellettoNantes
Bologna,Santiago Castro,510,ar ARG,FW,it Serie A,19,2004,25.5,18,10,4,9,5,6,17,35.3,11,13,2,11,3,21,20,0,Santiago CastroBologna
Monza,Gaetano Castrovilli,511,it ITA,MF,it Serie A,27,1997,6.6,12,7,10,2,0,4,11,36.4,7,8,2,6,2,14,9,0,Gaetano CastrovilliMonza
Lazio,Gaetano Castrovilli,512,it ITA,"MF,FW",it Serie A,27,1997,1.6,5,2,3,1,1,2,4,50.0,2,3,0,3,3,8,1,0,Gaetano CastrovilliLazio
Fiorentina,Danilo Cataldi,513,it ITA,MF,it Serie A,29,1994,19.0,25,16,13,10,2,14,27,51.9,13,17,8,9,22,47,35,0,Danilo CataldiFiorentina
Osasuna,Catena,514,es ESP,DF,es La Liga,29,1994,34.2,46,28,34,10,2,27,44,61.4,17,40,25,15,35,81,221,2,CatenaOsasuna
Valencia,Maximiliano Caufriez,515,be BEL,DF,es La Liga,27,1997,1.0,1,1,1,0,0,1,1,100.0,0,2,1,1,1,2,4,0,Maximiliano CaufriezValencia
Angers,Enzo Caumont,516,fr FRA,MF,fr Ligue 1,20,2004,0.4,1,1,0,1,0,1,2,50.0,1,1,1,0,1,2,1,0,Enzo CaumontAngers
Real Madrid,Dani Ceballos,517,es ESP,MF,es La Liga,27,1996,13.5,41,21,17,18,6,20,40,50.0,20,16,4,12,14,55,10,2,Dani CeballosReal Madrid
St. Pauli,Abdoulie Ceesay,518,gm GAM,FW,de Bundesliga,20,2004,0.7,3,3,1,1,1,2,3,66.7,1,2,0,2,0,3,1,0,Abdoulie CeesaySt. Pauli
Roma,Zeki Celik,519,tr TUR,DF,it Serie A,27,1997,25.1,62,37,21,31,10,23,43,53.5,20,28,9,19,15,77,84,3,Zeki CelikRoma
Nantes,Fabien Centonze,520,fr FRA,DF,fr Ligue 1,28,1996,2.9,8,4,5,2,1,4,6,66.7,2,4,1,3,2,10,17,0,Fabien CentonzeNantes
Como,Alberto Cerri,521,it ITA,FW,it Serie A,28,1996,1.0,0,0,0,0,0,0,0,,0,2,0,2,0,0,1,0,Alberto CerriComo
Celta Vigo,Franco Cervi,522,ar ARG,"FW,MF",es La Liga,30,1994,3.0,8,3,2,6,0,3,8,37.5,5,4,0,4,8,16,7,0,Franco CerviCelta Vigo
Stuttgart,Julian Chabot,523,de GER,DF,de Bundesliga,26,1998,25.2,37,24,19,15,3,15,32,46.9,17,29,19,10,38,75,135,0,Julian ChabotStuttgart
RB Leipzig,El Chadaille Bitshiabu,524,fr FRA,DF,de Bundesliga,19,2005,12.6,27,18,17,9,1,10,19,52.6,9,25,14,11,13,40,97,2,El Chadaille BitshiabuRB Leipzig
Eint Frankfurt,Fares Chaibi,525,dz ALG,"MF,FW",de Bundesliga,21,2002,11.3,13,9,4,5,4,7,20,35.0,13,10,0,10,10,23,32,1,Fares ChaibiEint Frankfurt
Crystal Palace,Trevoh Chalobah,526,eng ENG,DF,eng Premier League,25,1999,11.8,20,16,7,12,1,12,23,52.2,11,19,9,10,19,39,57,3,Trevoh ChalobahCrystal Palace
Chelsea,Trevoh Chalobah,527,eng ENG,DF,eng Premier League,25,1999,10.1,11,7,5,6,0,7,8,87.5,1,6,3,3,10,21,48,1,Trevoh ChalobahChelsea
Eint Frankfurt,Timothy Chandler,528,us USA,DF,de Bundesliga,34,1990,0.3,0,0,0,0,0,0,0,,0,0,0,0,3,3,2,0,Timothy ChandlerEint Frankfurt
Ipswich Town,Conor Chaplin,529,eng ENG,"MF,FW",eng Premier League,27,1997,9.5,15,5,6,6,3,6,14,42.9,8,8,1,7,4,19,3,0,Conor ChaplinIpswich Town
Brest,Brendan Chardonnet,530,fr FRA,DF,fr Ligue 1,29,1994,26.8,45,33,28,14,3,25,40,62.5,15,45,28,17,29,74,169,2,Brendan ChardonnetBrest
Parma,Gabriel Charpentier,531,cg CGO,FW,it Serie A,25,1999,3.0,4,3,2,1,1,3,4,75.0,1,3,0,3,0,4,9,0,Gabriel CharpentierParma
Valladolid,Raul Chasco,532,es ESP,DF,es La Liga,20,2003,1.4,4,1,3,1,0,2,4,50.0,2,1,0,1,2,6,2,0,Raul ChascoValladolid
Stuttgart,Anrie Chase,533,jp JPN,DF,de Bundesliga,20,2004,8.2,10,4,6,4,0,5,7,71.4,2,10,6,4,9,19,35,0,Anrie ChaseStuttgart
Rayo Vallecano,Pep Chavarria,534,es ESP,"DF,FW",es La Liga,26,1998,28.7,46,36,30,14,2,28,45,62.2,17,35,9,26,30,76,108,1,Pep ChavarriaRayo Vallecano
Hoffenheim,Arthur Chaves,535,br BRA,DF,de Bundesliga,23,2001,24.3,51,36,28,19,4,25,50,50.0,25,47,20,27,37,88,136,3,Arthur ChavesHoffenheim
Lens,Jhoanner Chavez,536,ec ECU,"DF,MF",fr Ligue 1,22,2002,6.6,9,5,4,4,1,2,7,28.6,5,10,1,9,6,15,13,0,Jhoanner ChavezLens
Napoli,Walid Cheddira,537,ma MAR,FW,it Serie A,26,1998,0.1,0,0,0,0,0,0,0,,0,0,0,0,0,0,0,0,Walid CheddiraNapoli
Espanyol,Walid Cheddira,538,ma MAR,FW,es La Liga,26,1998,7.1,5,0,1,1,3,0,1,0.0,1,4,0,4,1,6,6,0,Walid CheddiraEspanyol
Real Madrid,Chema,539,es ESP,MF,es La Liga,19,2005,0.1,0,0,0,0,0,0,0,,0,0,0,0,0,0,1,0,ChemaReal Madrid
Montpellier,Theo Chennahi,540,fr FRA,DF,fr Ligue 1,19,2005,2.0,6,3,3,3,0,4,7,57.1,3,3,0,3,2,8,6,0,Theo ChennahiMontpellier
Angers,Sidiki Cherif,541,fr FRA,FW,fr Ligue 1,17,2006,3.6,5,5,1,3,1,3,4,75.0,1,4,1,3,0,5,0,1,Sidiki CherifAngers
Lyon,Rayan Cherki,542,fr FRA,"FW,MF",fr Ligue 1,20,2003,22.7,15,12,3,8,4,6,28,21.4,22,6,0,6,7,22,6,0,Rayan CherkiLyon
Everton,Youssef Chermiti,543,pt POR,"FW,MF",eng Premier League,20,2004,0.5,0,0,0,0,0,0,1,0.0,1,0,0,0,0,0,0,0,Youssef ChermitiEverton
Lille,Lucas Chevalier,544,fr FRA,GK,fr Ligue 1,22,2001,34.0,3,2,3,0,0,3,4,75.0,1,0,0,0,0,3,13,4,Lucas ChevalierLille
Gladbach,Fabio Chiarodia,545,it ITA,DF,de Bundesliga,19,2005,4.2,10,4,6,4,0,4,6,66.7,2,8,3,5,9,19,53,1,Fabio ChiarodiaGladbach
Leganes,Julian Chicco,546,ar ARG,"MF,DF",es La Liga,26,1998,3.4,11,7,3,6,2,5,8,62.5,3,2,0,2,4,15,10,0,Julian ChiccoLeganes
Parma,Leandro Chichizola,547,ar ARG,GK,it Serie A,34,1990,1.0,0,0,0,0,0,0,0,,0,0,0,0,0,0,2,0,Leandro ChichizolaParma
Liverpool,Federico Chiesa,548,it ITA,FW,eng Premier League,26,1997,1.2,1,0,0,1,0,0,2,0.0,2,1,0,1,0,1,1,1,Federico ChiesaLiverpool
Crystal Palace,Ben Chilwell,549,eng ENG,DF,eng Premier League,27,1996,2.9,7,6,4,3,0,1,5,20.0,4,6,2,4,6,13,16,0,Ben ChilwellCrystal Palace
Wolves,Chiquinho,550,pt POR,MF,eng Premier League,24,2000,0.1,0,0,0,0,0,0,0,,0,0,0,0,0,0,0,0,ChiquinhoWolves
Mallorca,Chiquinho,551,pt POR,"MF,FW",es La Liga,24,2000,1.6,1,0,0,1,0,0,7,0.0,7,3,0,3,2,3,0,0,ChiquinhoMallorca
Nantes,Pedro Chirivella,552,es ESP,MF,fr Ligue 1,27,1997,26.1,44,29,23,16,5,19,42,45.2,23,25,4,21,19,63,45,0,Pedro ChirivellaNantes
Montpellier,Joris Chotard,553,fr FRA,MF,fr Ligue 1,22,2001,21.0,39,27,17,20,2,20,46,43.5,26,28,10,18,19,58,52,1,Joris ChotardMontpellier
Leicester City,Hamza Choudhury,554,bd BAN,"MF,DF",eng Premier League,26,1997,1.5,1,1,1,0,0,1,3,33.3,2,4,2,2,5,6,2,0,Hamza ChoudhuryLeicester City
Barcelona,Andreas Christensen,555,dk DEN,DF,es La Liga,28,1996,2.8,6,4,4,1,1,4,4,100.0,0,2,0,2,4,10,9,0,Andreas ChristensenBarcelona
Bournemouth,Ryan Christie,556,sct SCO,MF,eng Premier League,29,1995,23.5,54,33,19,27,8,27,64,42.2,37,44,11,33,30,84,51,3,Ryan ChristieBournemouth
Dortmund,Carney Chukwuemeka,557,eng ENG,MF,de Bundesliga,20,2003,2.8,7,5,3,2,2,1,1,100.0,0,5,0,5,1,8,1,0,Carney ChukwuemekaDortmund
Milan,Samuel Chukwueze,558,ng NGA,"FW,MF",it Serie A,25,1999,10.3,17,11,7,6,4,5,19,26.3,14,3,0,3,2,19,9,0,Samuel ChukwuezeMilan
Torino,Aaron Ciammaglichella,559,it ITA,MF,it Serie A,19,2005,0.0,0,0,0,0,0,0,0,,0,0,0,0,0,0,0,0,Aaron CiammaglichellaTorino
Las Palmas,Jasper Cillessen,560,nl NED,GK,es La Liga,35,1989,25.9,1,0,1,0,0,1,4,25.0,3,0,0,0,0,1,11,2,Jasper CillessenLas Palmas
Cagliari,Giuseppe Ciocci,561,it ITA,GK,it Serie A,22,2002,0.1,0,0,0,0,0,0,0,,0,0,0,0,0,0,0,0,Giuseppe CiocciCagliari
Parma,Alessandro Circati,562,au AUS,DF,it Serie A,20,2003,6.0,7,5,6,1,0,1,2,50.0,1,5,4,1,3,10,42,1,Alessandro CircatiParma
Rayo Vallecano,Pathe Ciss,563,sn SEN,"MF,DF",es La Liga,30,1994,23.8,49,24,26,22,1,20,41,48.8,21,31,10,21,40,89,61,3,Pathe CissRayo Vallecano
Hellas Verona,Alphadjo Cisse,564,it ITA,"FW,MF",it Serie A,17,2006,0.1,0,0,0,0,0,0,0,,0,0,0,0,0,0,0,0,Alphadjo CisseHellas Verona
Rennes,Djaoui Cisse,565,fr FRA,MF,fr Ligue 1,20,2004,12.5,33,18,12,15,6,16,26,61.5,10,29,4,25,13,46,11,1,Djaoui CisseRennes
Leganes,Seydouba Cisse,566,gn GUI,MF,es La Liga,23,2001,27.1,59,37,18,27,14,23,50,46.0,27,25,1,24,12,71,45,1,Seydouba CisseLeganes
Auxerre,Yoann Cisse,567,fr FRA,MF,fr Ligue 1,19,2004,0.1,0,0,0,0,0,0,0,,0,0,0,0,1,1,0,0,Yoann CisseAuxerre
Monza,Patrick Ciurria,568,it ITA,"MF,DF",it Serie A,29,1995,12.3,22,14,11,7,4,4,11,36.4,7,13,3,10,6,28,22,0,Patrick CiurriaMonza
Ipswich Town,Harry Clarke,569,eng ENG,DF,eng Premier League,23,2001,4.2,5,3,3,2,0,3,6,50.0,3,5,4,1,4,9,14,3,Harry ClarkeIpswich Town
Ipswich Town,Jack Clarke,570,eng ENG,"FW,MF",eng Premier League,23,2000,13.1,32,20,11,10,11,17,34,50.0,17,9,0,9,7,39,29,2,Jack ClarkeIpswich Town
Augsburg,Alexis Claude-Maurice,571,fr FRA,"MF,FW",de Bundesliga,26,1998,23.4,41,26,12,15,14,17,34,50.0,17,16,0,16,15,56,8,1,Alexis Claude-MauriceAugsburg
Nice,Jonathan Clauss,572,fr FRA,"DF,MF",fr Ligue 1,31,1992,25.6,52,35,27,19,6,28,56,50.0,28,25,2,23,48,100,68,3,Jonathan ClaussNice
Girona,Silvi Clua,573,es ESP,MF,es La Liga,19,2005,1.8,8,7,4,3,1,4,6,66.7,2,1,0,1,2,10,6,0,Silvi CluaGirona
Crystal Palace,Nathaniel Clyne,574,eng ENG,"DF,MF",eng Premier League,33,1991,5.4,12,8,8,3,1,6,11,54.5,5,4,2,2,3,15,14,1,Nathaniel ClyneCrystal Palace
Leicester City,Conor Coady,575,eng ENG,DF,eng Premier League,31,1993,19.0,13,9,6,6,1,3,6,50.0,3,32,24,8,13,26,71,2,Conor CoadyLeicester City
Nantes,Marcus Coco,576,fr FRA,DF,fr Ligue 1,28,1996,10.6,27,21,15,9,3,16,31,51.6,15,16,5,11,11,38,46,0,Marcus CocoNantes
Torino,Saul Coco,577,gq EQG,DF,it Serie A,25,1999,31.6,46,26,31,14,1,19,30,63.3,11,49,31,18,38,84,157,4,Saul CocoTorino
Everton,Seamus Coleman,578,ie IRL,DF,eng Premier League,35,1988,2.4,3,2,2,1,0,3,4,75.0,1,5,3,2,1,4,8,0,Seamus ColemanEverton
Brentford,Nathan Collins,579,ie IRL,DF,eng Premier League,23,2001,38.0,40,24,23,12,5,22,36,61.1,14,77,57,20,34,74,226,3,Nathan CollinsBrentford
Eint Frankfurt,Nnamdi Collins,580,de GER,DF,de Bundesliga,20,2004,16.5,33,24,24,7,2,17,22,77.3,5,22,11,11,16,49,74,3,Nnamdi CollinsEint Frankfurt
Manchester Utd,Toby Collyer,581,eng ENG,MF,eng Premier League,20,2004,2.0,12,9,6,6,0,5,6,83.3,1,2,1,1,2,14,3,0,Toby CollyerManchester Utd
Empoli,Lorenzo Colombo,582,it ITA,"FW,MF",it Serie A,22,2002,24.8,31,14,7,16,8,7,21,33.3,14,33,2,31,2,33,16,1,Lorenzo ColomboEmpoli
Fiorentina,Andrea Colpani,583,it ITA,"FW,MF",it Serie A,25,1999,15.9,15,9,5,7,3,4,12,33.3,8,7,0,7,8,23,10,0,Andrea ColpaniFiorentina
Chelsea,Levi Colwill,584,eng ENG,DF,eng Premier League,21,2003,35.0,47,34,25,19,3,18,27,66.7,9,37,25,12,33,80,118,4,Levi ColwillChelsea
Cagliari,Florinel Coman,585,ro ROU,"FW,MF",it Serie A,26,1998,2.9,5,3,3,1,1,2,2,100.0,0,2,0,2,1,6,3,0,Florinel ComanCagliari
Bayern Munich,Kingsley Coman,586,fr FRA,FW,de Bundesliga,28,1996,14.2,17,12,6,6,5,8,12,66.7,4,12,0,12,8,25,15,0,Kingsley ComanBayern Munich
Valladolid,Eray Comert,587,ch SUI,"DF,MF",es La Liga,26,1998,19.8,24,14,15,9,0,12,21,57.1,9,28,15,13,24,48,75,2,Eray ComertValladolid
Villarreal,Santi Comesana,588,es ESP,MF,es La Liga,27,1996,28.4,85,49,44,32,9,42,76,55.3,34,56,22,34,19,104,56,1,Santi ComesanaVillarreal
Fiorentina,Pietro Comuzzo,589,it ITA,DF,it Serie A,19,2005,23.4,43,21,29,11,3,23,29,79.3,6,35,22,13,29,72,113,4,Pietro ComuzzoFiorentina
Juventus,Francisco Conceicao,590,pt POR,"FW,MF",it Serie A,21,2002,14.9,23,14,6,9,8,13,30,43.3,17,7,0,7,6,29,6,0,Francisco ConceicaoJuventus
Villarreal,Diego Conde,591,es ESP,GK,es La Liga,25,1998,21.8,2,2,2,0,0,2,4,50.0,2,0,0,0,1,3,9,2,Diego CondeVillarreal
Alaves,Tomas Conechny,592,ar ARG,"FW,MF",es La Liga,26,1998,9.4,15,12,6,7,2,9,27,33.3,18,14,2,12,6,21,10,0,Tomas ConechnyAlaves
Le Havre,Alois Confais,593,fr FRA,MF,fr Ligue 1,27,1996,0.0,0,0,0,0,0,0,0,,0,0,0,0,0,0,0,0,Alois ConfaisLe Havre
Heidenheim,Sirlord Conteh,594,de GER,"FW,MF",de Bundesliga,28,1996,9.9,9,5,3,6,0,2,7,28.6,5,1,1,0,1,10,8,0,Sirlord ContehHeidenheim
Bournemouth,Lewis Cook,595,eng ENG,"MF,DF",eng Premier League,27,1997,33.1,81,42,41,36,4,37,67,55.2,30,30,11,19,41,122,70,0,Lewis CookBournemouth
Mallorca,Copete,596,es ESP,DF,es La Liga,24,1999,17.0,29,17,18,10,1,11,12,91.7,1,24,16,8,17,46,123,2,CopeteMallorca
Hellas Verona,Diego Coppola,597,it ITA,DF,it Serie A,20,2003,32.5,66,36,48,14,4,28,40,70.0,12,44,24,20,72,138,194,2,Diego CoppolaHellas Verona
Nantes,Francis Coquelin,598,fr FRA,MF,fr Ligue 1,33,1991,2.5,9,5,5,3,1,3,4,75.0,1,3,1,2,6,15,3,0,Francis CoquelinNantes
Valencia,Iker Cordoba,599,es ESP,DF,es La Liga,18,2005,0.2,0,0,0,0,0,0,0,,0,0,0,0,0,0,1,0,Iker CordobaValencia
Marseille,Derek Cornelius,600,ca CAN,DF,fr Ligue 1,26,1997,15.8,24,17,15,8,1,17,22,77.3,5,16,10,6,14,38,51,0,Derek CorneliusMarseille
Southampton,Maxwel Cornet,601,ci CIV,FW,eng Premier League,27,1996,0.8,5,5,1,4,0,0,4,0.0,4,0,0,0,0,5,2,0,Maxwel CornetSouthampton
Genoa,Maxwel Cornet,602,ci CIV,"FW,MF",it Serie A,27,1996,2.7,2,1,1,0,1,0,1,0.0,1,1,1,0,2,4,2,0,Maxwel CornetGenoa
Saint-Etienne,Pierre Cornud,603,fr FRA,DF,fr Ligue 1,27,1996,6.4,12,10,6,4,2,8,17,47.1,9,9,4,5,9,21,28,1,Pierre CornudSaint-Etienne
Atletico Madrid,Angel Correa,604,ar ARG,"FW,MF",es La Liga,29,1995,8.9,9,3,4,1,4,5,15,33.3,10,10,0,10,4,13,8,0,Angel CorreaAtletico Madrid
Inter,Joaquin Correa,605,ar ARG,"FW,MF",it Serie A,29,1994,8.1,11,5,4,7,0,4,13,30.8,9,3,0,3,0,11,6,0,Joaquin CorreaInter
Valencia,Thierry Correia,606,pt POR,DF,es La Liga,25,1999,8.5,27,18,19,5,3,13,23,56.5,10,10,1,9,4,31,18,0,Thierry CorreiaValencia
Juventus,Alberto costa,607,pt POR,DF,it Serie A,20,2003,4.0,14,10,7,5,2,7,9,77.8,2,5,1,4,4,18,14,0,Alberto costaJuventus
Getafe,Coba da Costa,608,es ESP,"MF,FW",es La Liga,22,2002,11.2,29,13,9,16,4,13,26,50.0,13,24,0,24,8,37,10,0,Coba da CostaGetafe
Mainz 05,Danny da Costa,609,de GER,DF,de Bundesliga,31,1993,22.3,42,23,23,15,4,17,27,63.0,10,19,10,9,27,69,95,3,Danny da CostaMainz 05
Lens,David Costa,610,pt POR,"MF,FW",fr Ligue 1,23,2001,3.9,2,0,1,1,0,1,4,25.0,3,5,1,4,1,3,0,0,David CostaLens
Villarreal,Logan Costa,611,cv CPV,DF,es La Liga,23,2001,28.7,38,21,25,12,1,24,29,82.8,5,25,14,11,21,59,115,2,Logan CostaVillarreal
Toulouse,Logan Costa,612,cv CPV,DF,fr Ligue 1,23,2001,1.0,2,1,0,2,0,1,1,100.0,0,2,2,0,2,4,4,0,Logan CostaToulouse
Mallorca,Samu Costa,613,pt POR,MF,es La Liga,23,2000,29.4,90,44,45,42,3,35,79,44.3,44,48,15,33,32,122,85,1,Samu CostaMallorca
Brest,Gregoire Coudert,614,fr FRA,GK,fr Ligue 1,25,1999,2.0,0,0,0,0,0,0,0,,0,0,0,0,0,0,1,0,Gregoire CoudertBrest
West Ham,Vladimir Coufal,615,cz CZE,DF,eng Premier League,31,1992,11.9,22,15,13,7,2,10,22,45.5,12,13,11,2,8,30,39,1,Vladimir CoufalWest Ham
Lecce,Lassana Coulibaly,616,ml MLI,MF,it Serie A,28,1996,29.6,48,29,16,28,4,24,61,39.3,37,45,12,33,18,66,46,1,Lassana CoulibalyLecce
Auxerre,Lasso Coulibaly,617,ci CIV,"FW,MF",fr Ligue 1,21,2002,0.5,1,1,0,0,1,0,0,,0,0,0,0,0,1,0,0,Lasso CoulibalyAuxerre
Monaco,Mamadou Coulibaly,618,fr FRA,MF,fr Ligue 1,20,2004,0.1,1,0,0,1,0,0,0,,0,0,0,0,0,1,0,0,Mamadou CoulibalyMonaco
Brest,Soumaila Coulibaly,619,fr FRA,DF,fr Ligue 1,20,2003,4.9,4,2,2,2,0,1,1,100.0,0,7,2,5,5,9,26,0,Soumaila CoulibalyBrest
Montpellier,Tanguy Coulibaly,620,fr FRA,"FW,MF",fr Ligue 1,23,2001,16.5,32,24,13,15,4,14,33,42.4,19,18,2,16,11,43,3,1,Tanguy CoulibalyMontpellier
Leicester City,Woyo Coulibaly,621,ml MLI,DF,eng Premier League,25,1999,1.2,6,4,4,2,0,2,2,100.0,0,3,1,2,5,11,1,0,Woyo CoulibalyLeicester City
Parma,Woyo Coulibaly,622,ml MLI,DF,it Serie A,25,1999,12.0,13,10,9,2,2,5,11,45.5,6,19,2,17,8,21,25,0,Woyo CoulibalyParma
Angers,Marius Courcoul,623,fr FRA,"MF,DF",fr Ligue 1,17,2007,3.4,5,2,3,2,0,2,5,40.0,3,4,0,4,5,10,9,0,Marius CourcoulAngers
Real Madrid,Thibaut Courtois,624,be BEL,GK,es La Liga,32,1992,30.0,0,0,0,0,0,0,0,,0,0,0,0,1,1,15,1,Thibaut CourtoisReal Madrid
Dortmund,Yan Couto,625,br BRA,"DF,FW",de Bundesliga,22,2002,9.9,24,16,17,2,5,14,25,56.0,11,12,1,11,10,34,32,2,Yan CoutoDortmund
Nantes,Nicolas Cozza,626,fr FRA,"DF,MF",fr Ligue 1,25,1999,22.8,59,41,35,18,6,31,47,66.0,16,25,10,15,25,84,69,0,Nicolas CozzaNantes
West Ham,Aaron Cresswell,627,eng ENG,DF,eng Premier League,34,1989,9.2,11,7,5,5,1,9,11,81.8,2,9,4,5,8,19,37,0,Aaron CresswellWest Ham
Toulouse,Charlie Cresswell,628,eng ENG,DF,fr Ligue 1,21,2002,28.8,35,23,19,15,1,28,46,60.9,18,44,28,16,28,63,191,3,Charlie CresswellToulouse
Roma,Bryan Cristante,629,it ITA,MF,it Serie A,29,1995,22.7,48,29,18,24,6,15,26,57.7,11,20,10,10,19,67,36,1,Bryan CristanteRoma
Venezia,Domen Crnigoj,630,si SVN,MF,it Serie A,28,1995,1.5,4,2,0,1,3,1,2,50.0,1,5,2,3,4,8,4,0,Domen CrnigojVenezia
Osasuna,Juan Cruz Armada,631,es ESP,DF,es La Liga,32,1992,16.6,26,14,11,13,2,15,24,62.5,9,15,4,11,9,35,68,0,Juan Cruz ArmadaOsasuna
Leganes,Juan Cruz,632,es ESP,"FW,MF",es La Liga,24,2000,25.1,32,19,14,16,2,17,35,48.6,18,18,2,16,13,45,31,0,Juan CruzLeganes
Atalanta,Juan Cuadrado,633,co COL,"DF,MF",it Serie A,36,1988,9.2,19,9,9,6,4,11,23,47.8,12,14,2,12,7,26,9,0,Juan CuadradoAtalanta
Barcelona,Pau Cubarsi,634,es ESP,DF,es La Liga,17,2007,29.1,34,23,21,10,3,19,30,63.3,11,12,9,3,16,50,86,1,Pau CubarsiBarcelona
Betis,Cucho,635,co COL,FW,es La Liga,25,1999,12.7,15,10,2,5,8,6,11,54.5,5,13,1,12,7,22,4,0,CuchoBetis
Chelsea,Marc Cucurella,636,es ESP,DF,eng Premier League,26,1998,33.2,67,45,31,31,5,32,61,52.5,29,49,16,33,28,95,95,3,Marc CucurellaChelsea
Fulham,Jorge Cuenca,637,es ESP,DF,eng Premier League,24,1999,3.9,6,2,5,1,0,3,8,37.5,5,4,4,0,2,8,26,0,Jorge CuencaFulham
Wolves,Matheus Cunha,638,br BRA,"MF,FW",eng Premier League,25,1999,28.9,38,22,17,16,5,13,39,33.3,26,21,1,20,17,55,23,0,Matheus CunhaWolves
Como,Patrick Cutrone,639,it ITA,FW,it Serie A,26,1998,22.7,16,11,0,10,6,7,14,50.0,7,11,0,11,5,21,7,0,Patrick CutroneComo
Gladbach,Tomas Cvancara,640,cz CZE,FW,de Bundesliga,23,2000,9.2,4,1,3,1,0,2,7,28.6,5,6,3,3,5,9,17,0,Tomas CvancaraGladbach
Parma,Wylan Cyprien,641,fr FRA,MF,it Serie A,29,1995,0.3,0,0,0,0,0,0,1,0.0,1,1,0,1,1,1,0,0,Wylan CyprienParma
Monza,Danilo D'Ambrosio,642,it ITA,DF,it Serie A,35,1988,12.2,28,15,17,10,1,14,23,60.9,9,12,8,4,15,43,36,2,Danilo D'AmbrosioMonza
Como,Lucas Da Cunha,643,fr FRA,MF,it Serie A,23,2001,29.0,45,25,17,19,9,20,39,51.3,19,18,3,15,17,62,30,1,Lucas Da CunhaComo
Roma,Samuel Dahl,644,se SWE,"DF,MF",it Serie A,24,2000,0.5,2,2,0,2,0,1,2,50.0,1,2,0,2,0,2,0,0,Samuel DahlRoma
Augsburg,Finn Dahmen,645,de GER,GK,de Bundesliga,26,1998,19.0,1,0,1,0,0,1,2,50.0,1,0,0,0,0,1,9,0,Finn DahmenAugsburg
Holstein Kiel,Thomas Dahne,646,de GER,GK,de Bundesliga,30,1994,9.0,0,0,0,0,0,0,0,,0,0,0,0,0,0,7,2,Thomas DahneHolstein Kiel
Eint Frankfurt,Mahmoud Dahoud,647,de GER,MF,de Bundesliga,28,1996,4.0,9,4,4,5,0,4,6,66.7,2,5,1,4,2,11,5,0,Mahmoud DahoudEint Frankfurt
Leicester City,Patson Daka,648,zm ZAM,"FW,MF",eng Premier League,25,1998,8.2,19,10,6,9,4,7,18,38.9,11,7,1,6,1,20,12,0,Patson DakaLeicester City
Stuttgart,Ameen Al-Dakhil,649,be BEL,DF,de Bundesliga,22,2002,4.8,6,6,4,2,0,4,4,100.0,0,12,8,4,9,15,30,1,Ameen Al-DakhilStuttgart
Bologna,Thijs Dallinga,650,nl NED,FW,it Serie A,23,2000,12.8,10,5,0,4,6,3,3,100.0,0,10,1,9,1,11,13,1,Thijs DallingaBologna
Manchester Utd,Diogo Dalot,651,pt POR,DF,eng Premier League,25,1999,31.3,68,40,40,22,6,34,52,65.4,18,22,9,13,37,105,72,0,Diogo DalotManchester Utd
Brentford,Mikkel Damsgaard,652,dk DEN,"MF,FW",eng Premier League,24,2000,32.3,83,44,27,29,27,31,81,38.3,50,40,3,37,27,110,31,2,Mikkel DamsgaardBrentford
Fiorentina,Maat Daniel Caprini,653,it ITA,FW,it Serie A,18,2006,0.1,0,0,0,0,0,0,0,,0,0,0,0,0,0,0,0,Maat Daniel CapriniFiorentina
Hellas Verona,Flavius Daniliuc,654,at AUT,DF,it Serie A,23,2001,11.2,26,21,14,9,3,15,24,62.5,9,10,3,7,7,33,27,0,Flavius DaniliucHellas Verona
Nott'ham Forest,Danilo,655,br BRA,"MF,FW",eng Premier League,23,2001,3.1,8,4,7,1,0,3,6,50.0,3,2,1,1,4,12,3,0,DaniloNott'ham Forest
Juventus,Danilo,656,br BRA,DF,it Serie A,33,1991,6.5,10,4,7,2,1,5,10,50.0,5,4,3,1,9,19,21,1,DaniloJuventus
Villarreal,Arnaut Danjuma,657,nl NED,FW,es La Liga,27,1997,2.2,2,1,0,1,1,0,1,0.0,1,1,0,1,0,2,0,0,Arnaut DanjumaVillarreal
Girona,Arnaut Danjuma,658,nl NED,"FW,MF",es La Liga,27,1997,14.8,8,6,3,3,2,2,7,28.6,5,5,1,4,2,10,4,0,Arnaut DanjumaGirona
Liverpool,Jayden Danns,659,eng ENG,MF,eng Premier League,18,2006,0.1,0,0,0,0,0,0,1,0.0,1,0,0,0,0,0,0,0,Jayden DannsLiverpool
Auxerre,Kevin Danois,660,fr FRA,MF,fr Ligue 1,20,2004,16.2,49,30,20,22,7,20,46,43.5,26,17,3,14,20,69,20,0,Kevin DanoisAuxerre
Tottenham,Kevin Danso,661,at AUT,DF,eng Premier League,25,1998,9.4,7,5,4,3,0,6,11,54.5,5,15,14,1,6,13,71,1,Kevin DansoTottenham
Lens,Kevin Danso,662,at AUT,DF,fr Ligue 1,25,1998,12.0,19,7,12,5,2,12,16,75.0,4,25,19,6,20,39,62,1,Kevin DansoLens
Nice,Dante,663,br BRA,DF,fr Ligue 1,40,1983,21.8,32,15,17,13,2,15,29,51.7,14,29,14,15,34,66,74,1,DanteNice
Strasbourg,Pape Daouda Diongue,664,sn SEN,"MF,FW",fr Ligue 1,,,0.9,2,0,1,1,0,1,2,50.0,1,0,0,0,3,5,2,0,Pape Daouda DiongueStrasbourg
Reims,Mohamed Daramy,665,dk DEN,FW,fr Ligue 1,22,2002,0.2,0,0,0,0,0,0,0,,0,0,0,0,0,0,1,0,Mohamed DaramyReims
Wolfsburg,Bence Dardai,666,hu HUN,MF,de Bundesliga,18,2006,14.5,24,14,9,13,2,16,30,53.3,14,20,4,16,12,36,28,1,Bence DardaiWolfsburg
Mallorca,Sergi Darder,667,es ESP,"MF,FW",es La Liga,30,1993,30.5,40,26,15,16,9,17,46,37.0,29,19,1,18,16,56,23,1,Sergi DarderMallorca
Inter,Matteo Darmian,668,it ITA,DF,it Serie A,34,1989,19.8,28,17,12,12,4,14,25,56.0,11,14,6,8,10,38,39,0,Matteo DarmianInter
Bochum,Lukas Daschner,669,de GER,"MF,FW",de Bundesliga,25,1998,4.6,4,2,1,2,1,2,9,22.2,7,5,0,5,0,4,5,0,Lukas DaschnerBochum
Juventus,Juan David Cabal,670,co COL,DF,it Serie A,23,2001,5.1,10,4,7,3,0,8,12,66.7,4,2,0,2,2,12,14,1,Juan David CabalJuventus
Lille,Jonathan David,671,ca CAN,FW,fr Ligue 1,24,2000,28.4,24,8,3,12,9,9,21,42.9,12,13,2,11,7,31,10,1,Jonathan DavidLille
Bayern Munich,Alphonso Davies,672,ca CAN,DF,de Bundesliga,23,2000,17.3,30,17,7,17,6,17,26,65.4,9,14,1,13,13,43,22,2,Alphonso DaviesBayern Munich
Tottenham,Ben Davies,673,wls WAL,DF,eng Premier League,31,1993,14.8,17,11,8,8,1,9,17,52.9,8,28,19,9,12,29,81,1,Ben DaviesTottenham
Udinese,Keinan Davis,674,eng ENG,FW,it Serie A,26,1998,11.8,9,4,1,4,4,3,6,50.0,3,2,1,1,1,10,5,0,Keinan DavisUdinese
Ipswich Town,Leif Davis,675,eng ENG,DF,eng Premier League,24,2000,30.5,46,27,33,9,4,30,48,62.5,18,25,8,17,25,71,77,3,Leif DavisIpswich Town
Saint-Etienne,Zuriko Davitashvili,676,ge GEO,"FW,MF",fr Ligue 1,23,2001,30.9,22,14,9,7,6,15,49,30.6,34,20,0,20,14,36,14,0,Zuriko DavitashviliSaint-Etienne
Hellas Verona,Pawel Dawidowicz,677,pl POL,"DF,MF",it Serie A,29,1995,20.5,45,24,20,22,3,18,27,66.7,9,16,6,10,20,65,70,2,Pawel DawidowiczHellas Verona
Wolves,Craig Dawson,678,eng ENG,DF,eng Premier League,34,1990,10.8,15,3,8,6,1,12,15,80.0,3,16,11,5,9,24,52,1,Craig DawsonWolves
Manchester City,Kevin De Bruyne,679,be BEL,"MF,FW",eng Premier League,33,1991,18.9,17,9,7,5,5,5,23,21.7,18,8,0,8,7,24,10,1,Kevin De BruyneManchester City
Leicester City,Bobby De Cordova-Reid,680,jm JAM,FW,eng Premier League,31,1993,8.3,9,4,3,6,0,4,14,28.6,10,6,1,5,0,9,10,0,Bobby De Cordova-ReidLeicester City
Atalanta,Charles De Ketelaere,681,be BEL,"MF,FW",it Serie A,23,2001,23.0,13,9,2,9,2,4,15,26.7,11,14,3,11,3,16,9,1,Charles De KetelaereAtalanta
Atletico Madrid,Rodrigo De Paul,682,ar ARG,MF,es La Liga,30,1994,23.4,33,26,12,16,5,14,33,42.4,19,25,2,23,6,39,15,3,Rodrigo De PaulAtletico Madrid
Auxerre,Theo De Percin,683,mq MTQ,GK,fr Ligue 1,23,2001,2.0,0,0,0,0,0,0,1,0.0,1,0,0,0,0,0,3,0,Theo De PercinAuxerre
Empoli,Mattia De Sciglio,684,it ITA,DF,it Serie A,31,1992,8.5,18,13,10,8,0,14,17,82.4,3,10,3,7,8,26,35,1,Mattia De SciglioEmpoli
Bologna,Lorenzo De Silvestri,685,it ITA,DF,it Serie A,36,1988,11.8,11,6,7,1,3,7,16,43.8,9,12,4,8,10,21,32,0,Lorenzo De SilvestriBologna
Reims,Thibault De Smet,686,be BEL,DF,fr Ligue 1,26,1998,2.1,6,4,5,1,0,4,4,100.0,0,5,3,2,4,10,12,0,Thibault De SmetReims
Genoa,Koni De Winter,687,be BEL,DF,it Serie A,22,2002,23.7,33,19,21,8,4,17,25,68.0,8,11,7,4,25,58,118,3,Koni De WinterGenoa
Marseille,Amar Dedic,688,ba BIH,DF,fr Ligue 1,21,2002,3.5,5,4,2,2,1,3,10,30.0,7,0,0,0,3,8,12,1,Amar DedicMarseille
Cagliari,Alessandro Deiola,689,it ITA,MF,it Serie A,28,1995,15.9,31,20,11,17,3,10,32,31.3,22,26,12,14,13,44,38,0,Alessandro DeiolaCagliari
Brest,Romain Del Castillo,690,fr FRA,FW,fr Ligue 1,28,1996,14.0,31,22,9,13,9,19,32,59.4,13,16,0,16,6,37,5,0,Romain Del CastilloBrest
Parma,Enrico Del Prato,691,it ITA,DF,it Serie A,24,1999,32.7,33,17,24,8,1,19,26,73.1,7,69,35,34,19,52,132,2,Enrico Del PratoParma
Strasbourg,Thomas Delaine,692,fr FRA,DF,fr Ligue 1,32,1992,0.1,1,1,1,0,0,1,1,100.0,0,0,0,0,1,2,1,0,Thomas DelaineStrasbourg
Ipswich Town,Liam Delap,693,eng ENG,FW,eng Premier League,21,2003,28.8,11,8,3,3,5,2,15,13.3,13,8,0,8,2,13,28,0,Liam DelapIpswich Town
Lazio,Fisayo Dele-Bashiru,694,ng NGA,"MF,FW",it Serie A,23,2001,10.5,10,6,3,3,4,2,6,33.3,4,10,2,8,4,14,5,0,Fisayo Dele-BashiruLazio
Montpellier,Andy Delort,695,dz ALG,FW,fr Ligue 1,32,1991,6.7,4,3,1,2,1,1,2,50.0,1,3,1,2,0,4,3,0,Andy DelortMontpellier
Werder Bremen,Olivier Deman,696,be BEL,DF,de Bundesliga,24,2000,0.7,6,3,2,4,0,2,7,28.6,5,3,1,2,3,9,4,0,Olivier DemanWerder Bremen
Torino,Ali Dembele,697,fr FRA,DF,it Serie A,20,2004,4.3,9,5,6,3,0,4,4,100.0,0,6,2,4,1,10,11,1,Ali DembeleTorino
Paris S-G,Ousmane Dembele,698,fr FRA,FW,fr Ligue 1,27,1997,19.2,11,5,0,7,4,4,12,33.3,8,3,0,3,9,20,2,1,Ousmane DembeleParis S-G
Stuttgart,Ermedin Demirovic,699,ba BIH,FW,de Bundesliga,26,1998,20.6,12,7,3,4,5,3,12,25.0,9,14,3,11,3,15,12,0,Ermedin DemirovicStuttgart
Brentford,Sepp van den Berg,700,nl NED,DF,eng Premier League,22,2001,28.7,39,24,25,10,4,19,29,65.5,10,52,38,14,21,60,134,3,Sepp van den BergBrentford
Lyon,Remy Descamps,701,fr FRA,GK,fr Ligue 1,28,1996,1.0,0,0,0,0,0,0,0,,0,0,0,0,0,0,0,0,Remy DescampsLyon
Le Havre,Arthur Desmas,702,fr FRA,GK,fr Ligue 1,30,1994,18.0,0,0,0,0,0,0,1,0.0,1,0,0,0,0,0,9,1,Arthur DesmasLe Havre
Crystal Palace,Justin Devenny,703,nir NIR,MF,eng Premier League,20,2003,5.6,17,12,7,9,1,8,19,42.1,11,6,1,5,0,17,11,0,Justin DevennyCrystal Palace
Chelsea,Kiernan Dewsbury-Hall,704,eng ENG,"MF,FW",eng Premier League,25,1998,2.9,8,5,1,1,6,4,6,66.7,2,2,0,2,2,10,9,1,Kiernan Dewsbury-HallChelsea
Juventus,Michele Di Gregorio,705,it ITA,GK,it Serie A,27,1997,33.0,0,0,0,0,0,0,0,,0,0,0,0,1,1,14,0,Michele Di GregorioJuventus
Napoli,Giovanni Di Lorenzo,706,it ITA,DF,it Serie A,30,1993,37.0,66,44,35,25,6,42,65,64.6,23,19,6,13,31,97,85,1,Giovanni Di LorenzoNapoli
Lazio,Boulaye Dia,707,sn SEN,"MF,FW",it Serie A,27,1996,24.2,22,10,5,12,5,7,16,43.8,9,12,1,11,6,28,16,1,Boulaye DiaLazio
Valencia,Mouctar Diakhaby,708,gn GUI,DF,es La Liga,27,1996,7.3,8,3,8,0,0,4,6,66.7,2,8,6,2,11,19,56,0,Mouctar DiakhabyValencia
Reims,Mamadou Diakhon,709,fr FRA,"FW,MF",fr Ligue 1,18,2005,9.5,12,8,4,3,5,9,18,50.0,9,5,1,4,4,16,5,0,Mamadou DiakhonReims
Lille,Bafode Diakite,710,fr FRA,DF,fr Ligue 1,23,2001,30.7,31,18,17,11,3,18,26,69.2,8,30,17,13,27,58,99,5,Bafode DiakiteLille
Reims,Oumar Diakite,711,ci CIV,FW,fr Ligue 1,20,2003,18.1,20,13,7,8,5,9,19,47.4,10,13,2,11,3,23,9,0,Oumar DiakiteReims
Manchester Utd,Amad Diallo,712,ci CIV,"MF,FW",eng Premier League,22,2002,21.1,38,31,9,20,9,19,32,59.4,13,15,2,13,11,49,19,1,Amad DialloManchester Utd
Como,Assane Diao,713,sn SEN,"FW,MF",it Serie A,18,2005,13.9,25,14,9,10,6,12,28,42.9,16,8,1,7,3,28,19,0,Assane DiaoComo
Betis,Assane Diao,714,sn SEN,FW,es La Liga,18,2005,3.1,5,3,1,3,1,4,9,44.4,5,3,0,3,0,5,3,0,Assane DiaoBetis
Strasbourg,Habib Diarra,715,sn SEN,"MF,FW",fr Ligue 1,20,2004,26.1,22,13,6,13,3,8,20,40.0,12,22,6,16,13,35,46,3,Habib DiarraStrasbourg
Alaves,Moussa Diarra,716,ml MLI,DF,es La Liga,23,2000,20.7,40,24,19,18,3,17,29,58.6,12,15,5,10,21,61,46,1,Moussa DiarraAlaves
Manchester City,Ruben Dias,717,pt POR,DF,eng Premier League,27,1997,25.2,17,11,7,9,1,7,13,53.8,6,23,20,3,20,37,71,4,Ruben DiasManchester City
Monaco,Krepin Diatta,718,sn SEN,"DF,FW",fr Ligue 1,25,1999,5.6,18,12,13,2,3,14,24,58.3,10,5,1,4,9,27,12,2,Krepin DiattaMonaco
Le Havre,Kandet Diawara,719,gn GUI,FW,fr Ligue 1,24,2000,0.0,0,0,0,0,0,0,0,,0,1,0,1,0,0,1,0,Kandet DiawaraLe Havre
Le Havre,Mahamadou Diawara,720,fr FRA,MF,fr Ligue 1,19,2005,6.5,20,12,10,8,2,8,13,61.5,5,13,6,7,13,33,11,1,Mahamadou DiawaraLe Havre
Lyon,Mahamadou Diawara,721,fr FRA,MF,fr Ligue 1,19,2005,0.2,1,0,0,1,0,1,3,33.3,2,2,0,2,0,1,0,0,Mahamadou DiawaraLyon
Real Madrid,Brahim Diaz,722,ma MAR,"FW,MF",es La Liga,24,1999,15.4,25,19,9,13,3,7,19,36.8,12,16,1,15,4,29,2,1,Brahim DiazReal Madrid
Real Sociedad,Daniel Diaz,723,es ESP,MF,es La Liga,18,2006,0.1,1,1,1,0,0,0,0,,0,1,0,1,0,1,0,0,Daniel DiazReal Sociedad
Liverpool,Luis Diaz,724,co COL,FW,eng Premier League,27,1997,26.7,39,26,13,20,6,15,39,38.5,24,19,0,19,7,46,7,1,Luis DiazLiverpool
Rayo Vallecano,Pedro Diaz,725,es ESP,MF,es La Liga,26,1998,13.5,23,15,7,14,2,14,41,34.1,27,16,0,16,7,30,7,1,Pedro DiazRayo Vallecano
Southampton,Tyler Dibling,726,eng ENG,"FW,MF",eng Premier League,18,2006,20.8,34,20,13,18,3,16,26,61.5,10,19,5,14,8,42,16,1,Tyler DiblingSouthampton
Leganes,Diego,727,es ESP,FW,es La Liga,24,2000,13.3,1,1,0,0,1,1,7,14.3,6,4,1,3,2,3,11,0,DiegoLeganes
Stuttgart,Justin Diehl,728,de GER,"FW,DF",de Bundesliga,19,2004,1.2,1,0,0,1,0,1,1,100.0,0,2,0,2,0,1,0,0,Justin DiehlStuttgart
Angers,Bamba Dieng,729,sn SEN,FW,fr Ligue 1,24,2000,5.9,4,1,1,2,1,0,2,0.0,2,2,0,2,0,4,3,0,Bamba DiengAngers
Bayern Munich,Eric Dier,730,eng ENG,DF,de Bundesliga,30,1994,16.3,19,11,8,9,2,13,20,65.0,7,19,8,11,20,39,77,1,Eric DierBayern Munich
Aston Villa,Lucas Digne,731,fr FRA,DF,eng Premier League,31,1993,26.1,65,38,40,16,9,44,66,66.7,22,23,4,19,25,90,89,1,Lucas DigneAston Villa
Lens,Kembo Diliwidi,732,fr FRA,DF,fr Ligue 1,18,2006,0.0,0,0,0,0,0,0,0,,0,0,0,0,0,0,0,0,Kembo DiliwidiLens
Inter,Federico Dimarco,733,it ITA,"DF,FW",it Serie A,26,1997,23.8,25,14,10,12,3,10,19,52.6,9,24,4,20,14,39,33,2,Federico DimarcoInter
Valencia,Stole Dimitrievski,734,mk MKD,GK,es La Liga,30,1993,4.0,0,0,0,0,0,0,0,,0,0,0,0,0,0,3,1,Stole DimitrievskiValencia
Eint Frankfurt,Junior Dina Ebimbe,735,fr FRA,"MF,FW",de Bundesliga,23,2000,3.3,3,2,1,2,0,1,3,33.3,2,4,0,4,7,10,6,0,Junior Dina EbimbeEint Frankfurt
Freiburg,Eren Dinkci,736,de GER,"MF,FW",de Bundesliga,22,2001,13.3,21,13,8,8,5,7,23,30.4,16,22,2,20,7,28,7,0,Eren DinkciFreiburg
Auxerre,Sinaly Diomande,737,ci CIV,DF,fr Ligue 1,23,2001,21.6,39,19,20,18,1,28,40,70.0,12,37,18,19,30,69,100,2,Sinaly DiomandeAuxerre
Leganes,Yan Diomande,738,ci CIV,"MF,FW",es La Liga,17,2006,6.1,14,9,1,8,5,5,15,33.3,10,8,0,8,8,22,6,0,Yan DiomandeLeganes
Angers,Lois Diony,739,fr FRA,FW,fr Ligue 1,31,1992,0.2,0,0,0,0,0,0,0,,0,0,0,0,0,0,0,0,Lois DionyAngers
Fulham,Issa Diop,740,fr FRA,DF,eng Premier League,27,1997,14.9,26,12,18,8,0,13,18,72.2,5,10,7,3,9,35,72,2,Issa DiopFulham
Brest,Serigne Diop,741,sn SEN,FW,fr Ligue 1,19,2005,0.0,1,0,0,1,0,0,0,,0,1,0,1,0,1,0,0,Serigne DiopBrest
Nice,Sofiane Diop,742,fr FRA,"MF,FW",fr Ligue 1,24,2000,11.8,23,16,16,3,4,9,22,40.9,13,19,2,17,17,40,7,1,Sofiane DiopNice
Lens,Andy Diouf,743,fr FRA,MF,fr Ligue 1,21,2003,24.7,37,26,10,22,5,16,40,40.0,24,24,1,23,15,52,18,2,Andy DioufLens
Reims,Yehvann Diouf,744,sn SEN,GK,fr Ligue 1,24,1999,34.0,2,1,2,0,0,1,3,33.3,2,0,0,0,1,3,22,4,Yehvann DioufReims
Auxerre,Assane Diousse,745,sn SEN,MF,fr Ligue 1,26,1997,7.4,15,7,9,5,1,5,14,35.7,9,6,2,4,12,27,15,0,Assane DiousseAuxerre
Aston Villa,Axel Disasi,746,fr FRA,DF,eng Premier League,26,1998,5.4,8,5,7,1,0,3,7,42.9,4,4,1,3,5,13,18,0,Axel DisasiAston Villa
Chelsea,Axel Disasi,747,fr FRA,DF,eng Premier League,26,1998,4.0,7,4,5,1,1,6,11,54.5,5,4,1,3,2,9,11,1,Axel DisasiChelsea
Everton,Roman Dixon,748,eng ENG,DF,eng Premier League,19,2004,1.0,5,5,3,2,0,4,4,100.0,0,1,0,1,1,6,3,0,Roman DixonEverton
Athletic Club,Alvaro djalo,749,es ESP,FW,es La Liga,24,1999,7.3,8,5,3,2,3,1,3,33.3,2,4,0,4,1,9,4,0,Alvaro djaloAthletic Club
Getafe,Djene,750,tg TOG,"DF,MF",es La Liga,32,1991,28.3,25,13,12,11,2,12,32,37.5,20,18,8,10,21,46,107,3,DjeneGetafe
Wolves,Nasser Djiga,751,bf BFA,DF,eng Premier League,21,2002,0.7,0,0,0,0,0,0,1,0.0,1,0,0,0,2,2,4,1,Nasser DjigaWolves
Atalanta,Berat Djimsiti,752,al ALB,DF,it Serie A,31,1993,29.3,53,33,29,23,1,29,40,72.5,11,34,21,13,40,93,141,2,Berat DjimsitiAtalanta
Leganes,Marko Dmitrovic,753,rs SRB,GK,es La Liga,32,1992,32.0,1,1,1,0,0,1,2,50.0,1,0,0,0,0,1,27,3,Marko DmitrovicLeganes
Freiburg,Ritsu Doan,754,jp JPN,"FW,MF",de Bundesliga,26,1998,31.8,66,42,33,26,7,25,46,54.3,21,57,2,55,14,80,47,1,Ritsu DoanFreiburg
Fiorentina,Dodo,755,br BRA,DF,it Serie A,25,1998,33.6,44,29,25,11,8,25,49,51.0,24,22,5,17,34,78,58,2,DodoFiorentina
Union Berlin,Danilho Doekhi,756,nl NED,DF,de Bundesliga,26,1998,34.0,37,24,18,16,3,13,23,56.5,10,35,16,19,44,81,169,1,Danilho DoekhiUnion Berlin
Wolves,Matt Doherty,757,ie IRL,DF,eng Premier League,32,1992,23.4,38,21,25,13,0,17,25,68.0,8,28,15,13,22,60,102,3,Matt DohertyWolves
Manchester City,Jeremy Doku,758,be BEL,"FW,MF",eng Premier League,22,2002,16.8,31,22,9,12,10,8,15,53.3,7,11,1,10,4,35,2,0,Jeremy DokuManchester City
Mallorca,Marc Domenech,759,es ESP,"FW,MF",es La Liga,18,2006,3.4,4,4,2,1,1,2,5,40.0,3,2,0,2,0,4,2,0,Marc DomenechMallorca
Toulouse,Alex Dominguez,760,es ESP,GK,fr Ligue 1,26,1998,0.2,0,0,0,0,0,0,0,,0,0,0,0,0,0,0,0,Alex DominguezToulouse
Bologna,Benjamin Dominguez,761,ar ARG,FW,it Serie A,20,2003,14.2,18,7,2,11,5,6,20,30.0,14,15,1,14,4,22,7,0,Benjamin DominguezBologna
Celta Vigo,Carlos Dominguez,762,es ESP,DF,es La Liga,23,2001,13.1,23,11,14,9,0,15,21,71.4,6,16,11,5,13,36,80,1,Carlos DominguezCelta Vigo
Sevilla,Israel Dominguez,763,es ESP,FW,es La Liga,21,2003,0.2,0,0,0,0,0,0,0,,0,0,0,0,0,0,0,0,Israel DominguezSevilla
Nott'ham Forest,Nicolas Dominguez,764,ar ARG,"MF,FW",eng Premier League,26,1998,21.8,86,45,40,35,11,36,76,47.4,40,38,12,26,29,115,54,1,Nicolas DominguezNott'ham Forest
Barcelona,Sergi Dominguez,765,es ESP,DF,es La Liga,19,2005,1.9,1,1,1,0,0,0,0,,0,0,0,0,3,4,7,0,Sergi DominguezBarcelona
Paris S-G,Gianluigi Donnarumma,766,it ITA,GK,fr Ligue 1,25,1999,23.2,1,1,1,0,0,1,2,50.0,1,0,0,0,0,1,14,0,Gianluigi DonnarummaParis S-G
Manchester Utd,Patrick Dorgu,767,dk DEN,DF,eng Premier League,19,2004,9.4,31,24,15,14,2,16,23,69.6,7,11,0,11,4,35,23,2,Patrick DorguManchester Utd
Lecce,Patrick Dorgu,768,dk DEN,"DF,FW",it Serie A,19,2004,20.4,45,27,21,19,5,23,45,51.1,22,24,6,18,18,63,42,2,Patrick DorguLecce
Tottenham,Alfie Dorrington,769,eng ENG,DF,eng Premier League,19,2005,0.2,0,0,0,0,0,0,0,,0,0,0,0,0,0,0,0,Alfie DorringtonTottenham
Augsburg,Niklas Dorsch,770,de GER,MF,de Bundesliga,26,1998,0.4,0,0,0,0,0,0,0,,0,1,0,1,0,0,0,0,Niklas DorschAugsburg
Heidenheim,Niklas Dorsch,771,de GER,MF,de Bundesliga,26,1998,14.8,27,16,12,15,0,13,22,59.1,9,14,1,13,17,44,17,2,Niklas DorschHeidenheim
Como,Alberto Dossena,772,it ITA,DF,it Serie A,25,1998,20.3,33,20,23,8,2,16,28,57.1,12,22,11,11,22,55,89,1,Alberto DossenaComo
Everton,Abdoulaye Doucoure,773,ml MLI,MF,eng Premier League,31,1993,28.5,48,28,21,20,7,14,43,32.6,29,31,6,25,10,58,20,1,Abdoulaye DoucoureEverton
Crystal Palace,Cheick Doucoure,774,ml MLI,MF,eng Premier League,24,2000,5.0,16,8,6,8,2,5,11,45.5,6,4,0,4,11,27,10,1,Cheick DoucoureCrystal Palace
Nantes,Sekou Doucoure,775,fr FRA,DF,fr Ligue 1,19,2005,0.1,0,0,0,0,0,0,0,,0,0,0,0,0,0,3,0,Sekou DoucoureNantes
Paris S-G,Desire Doue,776,fr FRA,"FW,MF",fr Ligue 1,19,2005,19.2,48,30,15,19,14,24,51,47.1,27,26,0,26,13,61,7,0,Desire DoueParis S-G
Strasbourg,Guela Doue,777,ci CIV,DF,fr Ligue 1,21,2002,30.2,65,45,40,15,10,37,54,68.5,17,38,6,32,34,99,154,1,Guela DoueStrasbourg
Nantes,Douglas,778,br BRA,MF,fr Ligue 1,27,1997,25.6,69,42,29,31,9,26,44,59.1,18,51,11,40,32,101,47,0,DouglasNantes
Strasbourg,Ismael Doukoure,779,fr FRA,"DF,MF",fr Ligue 1,21,2003,29.3,40,22,19,18,3,17,25,68.0,8,31,14,17,25,65,102,3,Ismael DoukoureStrasbourg
Venezia,Issa Doumbia,780,it ITA,MF,it Serie A,20,2003,10.4,14,8,6,7,1,7,17,41.2,10,17,5,12,9,23,14,1,Issa DoumbiaVenezia
Brest,Kamory Doumbia,781,ml MLI,"MF,FW",fr Ligue 1,21,2003,14.7,41,29,17,17,7,14,31,45.2,17,17,1,16,28,69,13,1,Kamory DoumbiaBrest
Nice,Amidou Doumbouya,782,fr FRA,DF,fr Ligue 1,16,2007,0.5,1,1,0,0,1,1,1,100.0,0,3,1,2,1,2,1,0,Amidou DoumbouyaNice
Como,Anastasios Douvikas,783,gr GRE,FW,it Serie A,24,1999,6.4,3,2,0,3,0,1,4,25.0,3,3,0,3,1,4,3,0,Anastasios DouvikasComo
Celta Vigo,Anastasios Douvikas,784,gr GRE,FW,es La Liga,24,1999,7.8,9,4,2,6,1,3,6,50.0,3,5,2,3,3,12,6,0,Anastasios DouvikasCelta Vigo
Roma,Artem Dovbyk,785,ua UKR,FW,it Serie A,27,1997,26.9,4,2,0,1,3,0,4,0.0,4,10,3,7,2,6,12,0,Artem DovbykRoma
Southampton,Flynn Downes,786,eng ENG,MF,eng Premier League,25,1999,23.9,49,25,23,21,5,15,36,41.7,21,28,9,19,32,81,51,4,Flynn DownesSouthampton
Wolves,Tommy Doyle,787,eng ENG,MF,eng Premier League,22,2001,5.4,11,6,6,3,2,6,15,40.0,9,11,5,6,5,16,11,1,Tommy DoyleWolves
Tottenham,Radu Dragusin,788,ro ROU,DF,eng Premier League,22,2002,13.9,10,6,8,2,0,6,12,50.0,6,22,16,6,15,25,49,4,Radu DragusinTottenham
Bochum,Patrick Drewes,789,de GER,GK,de Bundesliga,31,1993,21.0,0,0,0,0,0,0,1,0.0,1,1,0,1,0,0,11,1,Patrick DrewesBochum
Hoffenheim,Tim Drexler,790,de GER,DF,de Bundesliga,19,2005,4.0,17,7,11,6,0,9,12,75.0,3,6,4,2,1,18,9,1,Tim DrexlerHoffenheim
Getafe,Domingos Duarte,791,pt POR,DF,es La Liga,29,1995,20.7,28,15,22,4,2,17,21,81.0,4,28,16,12,18,46,152,1,Domingos DuarteGetafe
Newcastle Utd,Martin Dubravka,792,sk SVK,GK,eng Premier League,35,1989,10.0,0,0,0,0,0,0,0,,0,0,0,0,0,0,3,0,Martin DubravkaNewcastle Utd
Werder Bremen,Marvin Ducksch,793,de GER,FW,de Bundesliga,30,1994,26.9,10,7,3,5,2,3,14,21.4,11,10,2,8,8,18,26,3,Marvin DuckschWerder Bremen
Hellas Verona,Ondrej Duda,794,sk SVK,MF,it Serie A,29,1994,26.6,46,27,21,22,3,29,64,45.3,35,28,9,19,31,77,30,4,Ondrej DudaHellas Verona
Leganes,Duk,795,cv CPV,"MF,FW",es La Liga,24,2000,2.0,8,4,3,3,2,3,5,60.0,2,4,0,4,1,9,2,0,DukLeganes
Inter,Denzel Dumfries,796,nl NED,"DF,FW",it Serie A,28,1996,20.7,25,15,12,9,4,14,27,51.9,13,31,8,23,6,31,26,1,Denzel DumfriesInter
Venezia,Alfred Duncan,797,gh GHA,MF,it Serie A,31,1993,10.6,17,8,4,11,2,5,14,35.7,9,7,2,5,8,25,8,0,Alfred DuncanVenezia
Brighton,Lewis Dunk,798,eng ENG,DF,eng Premier League,32,1991,23.1,17,10,8,7,2,11,19,57.9,8,28,18,10,13,30,79,2,Lewis DunkBrighton
Aston Villa,Jader Duran,799,co COL,FW,eng Premier League,20,2003,7.1,8,7,1,2,5,1,4,25.0,3,5,0,5,0,8,13,0,Jader DuranAston Villa
Celta Vigo,Pablo Duran,800,es ESP,"FW,MF",es La Liga,23,2001,15.5,17,9,4,7,6,5,16,31.3,11,12,3,9,8,25,18,0,Pablo DuranCelta Vigo
Dortmund,Julien Duranville,801,be BEL,"FW,MF",de Bundesliga,18,2006,3.1,3,0,0,3,0,1,2,50.0,1,1,0,1,0,3,3,0,Julien DuranvilleDortmund
Valencia,Hugo Duro,802,es ESP,FW,es La Liga,24,1999,24.1,13,8,4,7,2,5,13,38.5,8,11,2,9,10,23,11,0,Hugo DuroValencia
Nantes,Jean-Kevin Duverne,803,ht HAI,DF,fr Ligue 1,27,1997,6.0,21,12,13,4,4,15,27,55.6,12,10,3,7,8,29,23,0,Jean-Kevin DuverneNantes
Roma,Paulo Dybala,804,ar ARG,"FW,MF",it Serie A,30,1993,15.7,17,7,3,9,5,8,19,42.1,11,12,1,11,2,19,2,0,Paulo DybalaRoma
Montpellier,Stefan Dzodic,805,rs SRB,"DF,MF",fr Ligue 1,19,2005,2.7,8,5,3,5,0,5,8,62.5,3,5,4,1,5,13,10,1,Stefan DzodicMontpellier
St. Pauli,Adam Dzwigala,806,pl POL,"DF,MF",de Bundesliga,28,1995,4.1,20,10,13,6,1,11,16,68.8,5,6,1,5,4,24,28,0,Adam DzwigalaSt. Pauli
Toulouse,Aron Donnum,807,no NOR,"DF,MF",fr Ligue 1,26,1998,29.9,56,35,25,24,7,31,55,56.4,24,29,4,25,28,84,37,1,Aron DonnumToulouse
Udinese,Enzo Ebosse,808,cm CMR,DF,it Serie A,25,1999,1.0,0,0,0,0,0,0,2,0.0,2,3,3,0,1,1,1,0,Enzo EbosseUdinese
Empoli,Tyronne Ebuehi,809,ng NGA,"DF,MF",it Serie A,28,1995,0.8,3,2,1,2,0,1,1,100.0,0,1,0,1,2,5,0,0,Tyronne EbuehiEmpoli
Manchester City,Claudio Echeverri,810,ar ARG,FW,eng Premier League,18,2006,0.1,1,0,0,1,0,1,1,100.0,0,0,0,0,0,1,0,0,Claudio EcheverriManchester City
Manchester City,Ederson,811,br BRA,GK,eng Premier League,30,1993,25.8,0,0,0,0,0,0,2,0.0,2,0,0,0,1,1,11,4,EdersonManchester City
Atalanta,Ederson,812,br BRA,MF,it Serie A,25,1999,32.0,52,32,19,28,5,22,34,64.7,12,30,6,24,35,87,36,1,EdersonAtalanta
Toulouse,Noah Edjouma,813,fr FRA,"MF,FW",fr Ligue 1,18,2005,1.9,2,2,0,1,1,1,2,50.0,1,1,1,0,2,4,2,0,Noah EdjoumaToulouse
Ipswich Town,George Edmundson,814,eng ENG,DF,eng Premier League,26,1997,0.0,0,0,0,0,0,0,0,,0,0,0,0,0,0,0,0,George EdmundsonIpswich Town
Crystal Palace,Odsonne Edouard,815,fr FRA,"MF,FW",eng Premier League,26,1998,1.3,1,0,0,1,0,0,2,0.0,2,1,0,1,0,1,1,0,Odsonne EdouardCrystal Palace
Leicester City,Odsonne Edouard,816,fr FRA,FW,eng Premier League,26,1998,0.3,1,1,1,0,0,0,0,,0,0,0,0,0,1,1,0,Odsonne EdouardLeicester City
Southampton,Samuel Edozie,817,eng ENG,"DF,FW",eng Premier League,21,2003,0.7,3,1,0,1,2,2,2,100.0,0,0,0,0,0,3,0,0,Samuel EdozieSouthampton
Southampton,Ronnie Edwards,818,eng ENG,DF,eng Premier League,21,2003,0.1,0,0,0,0,0,0,0,,0,1,1,0,0,0,0,0,Ronnie EdwardsSouthampton
St. Pauli,Johannes Eggestein,819,de GER,FW,de Bundesliga,26,1998,20.6,5,3,0,2,3,1,5,20.0,4,5,0,5,0,5,8,0,Johannes EggesteinSt. Pauli
Freiburg,Maximilian Eggestein,820,de GER,MF,de Bundesliga,27,1996,31.6,57,32,21,26,10,24,43,55.8,19,37,10,27,39,96,54,1,Maximilian EggesteinFreiburg
Udinese,Kingsley Ehizibue,821,nl NED,DF,it Serie A,29,1995,27.8,55,35,31,18,6,25,41,61.0,16,41,14,27,23,78,70,5,Kingsley EhizibueUdinese
Sevilla,Chidera Ejuke,822,ng NGA,FW,es La Liga,26,1998,10.7,19,13,8,9,2,9,20,45.0,11,12,0,12,5,24,8,0,Chidera EjukeSevilla
Genoa,Jeff Ekhator,823,it ITA,"FW,MF",it Serie A,17,2006,8.5,7,4,4,1,2,4,9,44.4,5,10,1,9,2,9,5,0,Jeff EkhatorGenoa
Eint Frankfurt,Hugo Ekitike,824,fr FRA,FW,de Bundesliga,22,2002,28.5,16,12,3,8,5,4,12,33.3,8,13,1,12,7,23,24,0,Hugo EkitikeEint Frankfurt
Udinese,Jurgen Ekkelenkamp,825,nl NED,MF,it Serie A,24,2000,21.0,36,25,10,22,4,18,35,51.4,17,26,4,22,12,48,26,0,Jurgen EkkelenkampUdinese
Angers,Jacques Ekomie,826,ga GAB,"DF,FW",fr Ligue 1,20,2003,7.7,22,14,9,10,3,8,12,66.7,4,16,5,11,4,26,14,0,Jacques EkomieAngers
Empoli,Emmanuel Ekong,827,se SWE,"MF,FW",it Serie A,22,2002,2.1,4,3,0,2,2,3,3,100.0,0,2,1,1,1,5,1,0,Emmanuel EkongEmpoli
Genoa,Caleb Ekuban,828,gh GHA,FW,it Serie A,30,1994,6.2,3,3,1,1,1,1,1,100.0,0,4,1,3,1,4,6,0,Caleb EkubanGenoa
Saint-Etienne,Pierre Ekwah Elimby,829,fr FRA,MF,fr Ligue 1,22,2002,28.6,54,33,18,30,6,34,56,60.7,22,26,12,14,47,101,72,1,Pierre Ekwah ElimbySaint-Etienne
Nott'ham Forest,Anthony Elanga,830,se SWE,"FW,MF",eng Premier League,22,2002,27.8,19,14,8,8,3,5,17,29.4,12,11,1,10,6,25,25,0,Anthony ElangaNott'ham Forest
Nantes,Meschak Elia,831,cd COD,FW,fr Ligue 1,26,1997,1.9,7,5,3,2,2,1,1,100.0,0,3,0,3,0,7,2,0,Meschak EliaNantes
Venezia,Mikael Ellertsson,832,is ISL,"DF,MF",it Serie A,22,2002,27.4,58,26,37,14,7,33,61,54.1,28,42,5,37,17,75,79,0,Mikael EllertssonVenezia
Liverpool,Harvey Elliott,833,eng ENG,MF,eng Premier League,21,2003,4.1,5,3,3,1,1,2,8,25.0,6,7,2,5,1,6,3,1,Harvey ElliottLiverpool
Torino,Elif Elmas,834,mk MKD,"FW,MF",it Serie A,24,1999,11.3,10,7,3,5,2,4,10,40.0,6,8,2,6,6,16,5,2,Elif ElmasTorino
RB Leipzig,Elif Elmas,835,mk MKD,MF,de Bundesliga,24,1999,0.5,3,1,3,0,0,1,3,33.3,2,2,0,2,0,3,2,0,Elif ElmasRB Leipzig
Real Sociedad,Aritz Elustondo,836,es ESP,DF,es La Liga,30,1994,16.2,20,11,15,3,2,11,19,57.9,8,17,12,5,11,31,96,0,Aritz ElustondoReal Sociedad
Gladbach,Nico Elvedi,837,ch SUI,DF,de Bundesliga,27,1996,23.7,38,23,28,6,4,17,23,73.9,6,35,27,8,30,68,163,0,Nico ElvediGladbach
Rayo Vallecano,Adri Embarba,838,es ESP,"FW,MF",es La Liga,32,1992,17.9,41,20,17,17,7,18,47,38.3,29,18,1,17,13,54,14,2,Adri EmbarbaRayo Vallecano
Monaco,Breel Embolo,839,ch SUI,"FW,MF",fr Ligue 1,27,1997,20.5,22,17,7,7,8,5,16,31.3,11,11,0,11,3,25,10,1,Breel EmboloMonaco
Strasbourg,Emanuel Emegha,840,nl NED,FW,fr Ligue 1,21,2003,25.5,6,6,1,2,3,2,6,33.3,4,18,5,13,1,7,30,0,Emanuel EmeghaStrasbourg
Milan,Emerson,841,br BRA,DF,it Serie A,25,1999,15.3,45,28,24,16,5,16,34,47.1,18,13,2,11,14,59,56,0,EmersonMilan
Brentford,Yunus Emre Konak,842,tr TUR,"FW,MF",eng Premier League,18,2006,0.5,4,4,0,4,0,1,2,50.0,1,2,0,2,0,4,0,0,Yunus Emre KonakBrentford
Ipswich Town,Julio Enciso,843,py PAR,"MF,FW",eng Premier League,20,2004,9.7,12,9,3,6,3,4,11,36.4,7,8,1,7,1,13,6,0,Julio EncisoIpswich Town
Brighton,Julio Enciso,844,py PAR,"MF,FW",eng Premier League,20,2004,3.3,0,0,0,0,0,0,2,0.0,2,2,0,2,0,0,1,0,Julio EncisoBrighton
Liverpool,Wataru Endo,845,jp JPN,"MF,DF",eng Premier League,31,1993,3.0,12,8,7,5,0,6,10,60.0,4,8,1,7,6,18,9,0,Wataru EndoLiverpool
Real Madrid,Endrick,846,br BRA,FW,es La Liga,18,2006,4.0,1,1,1,0,0,1,3,33.3,2,0,0,0,4,5,1,0,EndrickReal Madrid
Como,Yannik Engelhardt,847,de GER,"MF,DF",it Serie A,23,2001,12.9,30,12,13,13,4,16,27,59.3,11,13,6,7,11,41,27,0,Yannik EngelhardtComo
Augsburg,Arne Engels,848,be BEL,"MF,FW",de Bundesliga,20,2003,0.9,0,0,0,0,0,0,0,,0,1,1,0,0,0,0,0,Arne EngelsAugsburg
Manchester Utd,Christian Eriksen,849,dk DEN,MF,eng Premier League,32,1992,11.8,19,9,4,12,3,11,27,40.7,16,15,5,10,7,26,8,0,Christian EriksenManchester Utd
Bologna,Martin Erlic,850,hr CRO,DF,it Serie A,26,1998,3.7,2,0,0,2,0,1,2,50.0,1,5,4,1,2,4,9,0,Martin ErlicBologna
Holstein Kiel,Patrick Erras,851,de GER,DF,de Bundesliga,29,1995,9.2,8,5,6,2,0,2,9,22.2,7,13,11,2,9,17,64,0,Patrick ErrasHolstein Kiel
Rayo Vallecano,Alfonso Espino,852,uy URU,DF,es La Liga,32,1992,9.3,41,24,31,8,2,26,47,55.3,21,19,6,13,12,53,32,1,Alfonso EspinoRayo Vallecano
Empoli,Sebastiano Esposito,853,it ITA,"FW,MF",it Serie A,22,2002,25.9,57,29,15,31,11,18,35,51.4,17,20,2,18,12,69,14,0,Sebastiano EspositoEmpoli
Crystal Palace,Romain Esse,854,eng ENG,MF,eng Premier League,19,2005,1.5,9,6,4,3,2,5,5,100.0,0,2,0,2,1,10,2,0,Romain EsseCrystal Palace
Augsburg,Samuel Essende,855,cd COD,FW,de Bundesliga,26,1998,18.2,7,6,1,3,3,3,4,75.0,1,13,2,11,0,7,11,1,Samuel EssendeAugsburg
Las Palmas,Dario Essugo,856,pt POR,MF,es La Liga,19,2005,21.5,59,45,28,26,5,28,46,60.9,18,28,11,17,42,101,47,7,Dario EssugoLas Palmas
Bologna,Estanis,857,es ESP,FW,it Serie A,20,2003,0.1,0,0,0,0,0,0,0,,0,0,0,0,0,0,0,0,EstanisBologna
Parma,Nahuel Estevez,858,ar ARG,MF,it Serie A,28,1995,7.3,16,6,7,8,1,6,15,40.0,9,9,2,7,3,19,26,0,Nahuel EstevezParma
Brighton,Pervis Estupinan,859,ec ECU,DF,eng Premier League,26,1998,26.7,65,43,33,25,7,34,51,66.7,17,20,5,15,37,102,65,2,Pervis EstupinanBrighton
Rayo Vallecano,Etienne Eto'o,860,cm CMR,FW,es La Liga,21,2002,0.4,0,0,0,0,0,0,1,0.0,1,0,0,0,0,0,1,0,Etienne Eto'oRayo Vallecano
Villarreal,Karl Etta,861,cm CMR,"MF,FW",es La Liga,20,2003,0.4,0,0,0,0,0,0,1,0.0,1,1,0,1,0,0,0,0,Karl EttaVillarreal
Bournemouth,Evanilson,862,br BRA,FW,eng Premier League,24,1999,25.8,16,10,6,5,5,8,12,66.7,4,11,2,9,1,17,21,0,EvanilsonBournemouth
Leicester City,Jake Evans,863,,FW,eng Premier League,,,0.3,1,1,0,0,1,0,1,0.0,1,0,0,0,0,1,1,0,Jake EvansLeicester City
Manchester Utd,Jonny Evans,864,nir NIR,DF,eng Premier League,36,1988,3.5,8,6,4,4,0,3,6,50.0,3,3,2,1,5,13,15,0,Jonny EvansManchester Utd
Espanyol,Edu Exposito,865,es ESP,MF,es La Liga,27,1996,11.6,23,13,9,13,1,9,23,39.1,14,3,0,3,15,38,21,2,Edu ExpositoEspanyol
Crystal Palace,Eberechi Eze,866,eng ENG,"MF,FW",eng Premier League,26,1998,28.8,39,22,14,16,9,17,36,47.2,19,27,0,27,11,50,10,3,Eberechi EzeCrystal Palace
Betis,Abde Ezzalzouli,867,ma MAR,"FW,MF",es La Liga,22,2001,22.0,37,25,17,16,4,15,27,55.6,12,22,3,19,7,44,19,0,Abde EzzalzouliBetis
Bologna,Giovanni Fabbian,868,it ITA,MF,it Serie A,21,2003,11.4,10,6,1,3,6,7,13,53.8,6,7,2,5,2,12,4,0,Giovanni FabbianBologna
West Ham,Lukasz Fabianski,869,pl POL,GK,eng Premier League,39,1985,12.9,0,0,0,0,0,0,1,0.0,1,0,0,0,0,0,5,1,Lukasz FabianskiWest Ham
Como,Alieu Fadera,870,gm GAM,"FW,DF",it Serie A,22,2001,18.3,64,47,25,27,12,20,45,44.4,25,18,1,17,12,76,10,0,Alieu FaderaComo
Leicester City,Wout Faes,871,be BEL,DF,eng Premier League,26,1998,31.3,42,26,26,14,2,25,48,52.1,23,48,35,13,26,68,185,4,Wout FaesLeicester City
Fiorentina,Nicolo Fagioli,872,it ITA,MF,it Serie A,23,2001,10.7,19,10,8,9,2,9,22,40.9,13,11,2,9,5,24,12,2,Nicolo FagioliFiorentina
Juventus,Nicolo Fagioli,873,it ITA,MF,it Serie A,23,2001,6.3,14,10,7,6,1,6,9,66.7,3,4,0,4,2,16,5,0,Nicolo FagioliJuventus
Brest,Romain Faivre,874,fr FRA,"MF,FW",fr Ligue 1,26,1998,10.0,13,10,4,5,4,5,10,50.0,5,8,0,8,4,17,3,1,Romain FaivreBrest
Lecce,Wladimiro Falcone,875,it ITA,GK,it Serie A,29,1995,38.0,0,0,0,0,0,0,0,,0,0,0,0,0,0,29,3,Wladimiro FalconeLecce
Hellas Verona,Davide Faraoni,876,it ITA,DF,it Serie A,32,1991,2.9,10,9,5,5,0,3,9,33.3,6,7,3,4,2,12,12,1,Davide FaraoniHellas Verona
Leicester City,Abdul Fatawu Issahaku,877,gh GHA,FW,eng Premier League,20,2004,6.4,21,15,13,2,6,11,19,57.9,8,7,0,7,4,25,12,0,Abdul Fatawu IssahakuLeicester City
Barcelona,Ansu Fati,878,es ESP,FW,es La Liga,21,2002,2.6,4,1,0,2,2,1,2,50.0,1,1,0,1,1,5,0,1,Ansu FatiBarcelona
Montpellier,Khalil Fayad,879,fr FRA,"MF,FW",fr Ligue 1,20,2004,11.4,31,16,12,17,2,15,28,53.6,13,18,1,17,10,41,15,1,Khalil FayadMontpellier
Empoli,Jacopo Fazzini,880,it ITA,MF,it Serie A,21,2003,15.4,32,19,11,16,5,13,23,56.5,10,13,1,12,6,38,24,0,Jacopo FazziniEmpoli
Betis,Nabil Fekir,881,fr FRA,MF,es La Liga,31,1993,2.0,3,2,1,1,1,1,2,50.0,1,2,0,2,0,3,0,0,Nabil FekirBetis
Cagliari,Mattia Felici,882,it ITA,"MF,FW",it Serie A,23,2001,10.3,17,12,8,7,2,4,11,36.4,7,10,0,10,7,24,7,1,Mattia FeliciCagliari
Marseille,Luiz Felipe,883,it ITA,DF,fr Ligue 1,27,1997,1.4,4,3,3,1,0,1,2,50.0,1,3,2,1,3,7,5,0,Luiz FelipeMarseille
Chelsea,Joao Felix,884,pt POR,"FW,MF",eng Premier League,24,1999,4.1,8,3,2,5,1,5,9,55.6,4,2,0,2,3,11,2,0,Joao FelixChelsea
Milan,Joao Felix,885,pt POR,MF,it Serie A,24,1999,8.4,6,6,3,2,1,4,14,28.6,10,2,0,2,1,7,9,0,Joao FelixMilan
Heidenheim,Frank Feller,886,de GER,GK,de Bundesliga,20,2004,1.3,0,0,0,0,0,0,0,,0,0,0,0,0,0,1,0,Frank FellerHeidenheim
Villarreal,Kiko Femenia,887,es ESP,DF,es La Liga,33,1991,24.7,50,34,34,14,2,33,57,57.9,24,21,10,11,40,90,62,3,Kiko FemeniaVillarreal
West Ham,Evan Ferguson,888,ie IRL,FW,eng Premier League,19,2004,1.7,3,1,0,1,2,0,0,,0,2,1,1,1,4,1,0,Evan FergusonWest Ham
Brighton,Evan Ferguson,889,ie IRL,FW,eng Premier League,19,2004,2.7,4,3,0,3,1,2,5,40.0,3,3,1,2,0,4,4,0,Evan FergusonBrighton
Bologna,Lewis Ferguson,890,sct SCO,MF,it Serie A,24,1999,10.9,24,13,4,14,6,9,16,56.3,7,9,2,7,5,29,9,0,Lewis FergusonBologna
Angers,Zinedine Ferhat,891,dz ALG,"FW,MF",fr Ligue 1,31,1993,9.4,9,7,1,5,3,4,13,30.8,9,9,0,9,10,19,12,0,Zinedine FerhatAngers
Manchester Utd,Bruno Fernandes,892,pt POR,MF,eng Premier League,29,1994,33.5,84,50,27,38,19,34,85,40.0,51,35,6,29,26,110,35,3,Bruno FernandesManchester Utd
Brest,Edimilson Fernandes,893,ch SUI,"MF,DF",fr Ligue 1,28,1996,12.3,9,7,3,6,0,7,13,53.8,6,14,6,8,20,29,38,1,Edimilson FernandesBrest
Southampton,Mateus Fernandes,894,pt POR,MF,eng Premier League,20,2004,32.3,89,48,45,28,16,33,72,45.8,39,43,8,35,28,117,35,7,Mateus FernandesSouthampton
Osasuna,Aitor Fernandez,895,es ESP,GK,es La Liga,33,1991,1.0,0,0,0,0,0,0,0,,0,0,0,0,0,0,2,0,Aitor FernandezOsasuna
Sevilla,Alvaro Fernandez,896,es ESP,GK,es La Liga,26,1998,8.3,0,0,0,0,0,0,1,0.0,1,0,0,0,0,0,7,0,Alvaro FernandezSevilla
Chelsea,Enzo Fernandez,897,ar ARG,MF,eng Premier League,23,2001,32.7,65,33,17,30,18,31,84,36.9,53,43,7,36,13,78,23,4,Enzo FernandezChelsea
Rayo Vallecano,Pelayo Fernandez,898,es ESP,DF,es La Liga,21,2003,1.1,0,0,0,0,0,0,0,,0,0,0,0,2,2,9,0,Pelayo FernandezRayo Vallecano
Espanyol,Roberto Fernandez,899,es ESP,FW,es La Liga,22,2002,16.6,4,4,2,1,1,0,5,0.0,5,9,1,8,3,7,26,0,Roberto FernandezEspanyol
Mallorca,Valery Fernandez,900,es ESP,"MF,FW",es La Liga,24,1999,3.4,8,7,3,2,3,5,7,71.4,2,3,1,2,0,8,1,0,Valery FernandezMallorca
Lille,Matias Fernandez-Pardo,901,be BEL,"FW,MF",fr Ligue 1,19,2005,11.8,12,9,3,6,3,6,12,50.0,6,9,0,9,3,15,6,0,Matias Fernandez-PardoLille
Valladolid,Andre Ferreira,902,pt POR,GK,es La Liga,28,1996,6.0,0,0,0,0,0,0,0,,0,0,0,0,0,0,4,2,Andre FerreiraValladolid
Montpellier,Jordan Ferri,903,fr FRA,MF,fr Ligue 1,32,1992,19.7,42,23,18,22,2,18,44,40.9,26,20,3,17,9,51,20,0,Jordan FerriMontpellier
Venezia,Daniel Fila,904,cz CZE,FW,it Serie A,21,2002,5.5,2,0,0,1,1,0,2,0.0,2,6,0,6,0,2,5,0,Daniel FilaVenezia
Strasbourg,Karol Fila,905,pl POL,MF,fr Ligue 1,26,1998,0.1,0,0,0,0,0,0,0,,0,0,0,0,0,0,0,0,Karol FilaStrasbourg
Wolfsburg,Kilian Fischer,906,de GER,DF,de Bundesliga,23,2000,25.5,64,44,48,12,4,47,89,52.8,42,41,8,33,19,83,98,2,Kilian FischerWolfsburg
Brentford,Mark Flekken,907,nl NED,GK,eng Premier League,31,1993,36.4,4,4,4,0,0,3,9,33.3,6,2,0,2,0,4,26,4,Mark FlekkenBrentford
Milan,Alessandro Florenzi,908,it ITA,FW,it Serie A,33,1991,0.1,0,0,0,0,0,0,0,,0,0,0,0,0,0,0,0,Alessandro FlorenziMilan
Betis,Mateo Flores,909,es ESP,MF,es La Liga,20,2004,1.7,3,1,3,0,0,1,1,100.0,0,1,0,1,2,5,3,0,Mateo FloresBetis
Manchester City,Phil Foden,910,eng ENG,"MF,FW",eng Premier League,24,2000,19.7,13,5,5,4,4,7,18,38.9,11,13,1,12,9,22,7,1,Phil FodenManchester City
Lyon,Malick Fofana,911,be BEL,FW,fr Ligue 1,19,2005,17.7,22,11,8,11,3,8,17,47.1,9,12,0,12,8,30,6,0,Malick FofanaLyon
Lens,Rayan Fofana,912,fr FRA,"FW,MF",fr Ligue 1,18,2006,0.3,2,2,1,1,0,0,0,,0,0,0,0,0,2,0,0,Rayan FofanaLens
Rennes,Seko Fofana,913,ci CIV,MF,fr Ligue 1,29,1995,9.4,11,7,4,6,1,2,7,28.6,5,7,1,6,7,18,7,0,Seko FofanaRennes
Chelsea,Wesley Fofana,914,fr FRA,DF,eng Premier League,23,2000,13.0,13,12,6,7,0,6,14,42.9,8,14,9,5,14,27,55,2,Wesley FofanaChelsea
Angers,Yahia Fofana,915,ci CIV,GK,fr Ligue 1,23,2000,33.0,0,0,0,0,0,0,2,0.0,2,0,0,0,1,1,25,2,Yahia FofanaAngers
Milan,Youssouf Fofana,916,fr FRA,MF,it Serie A,25,1999,27.8,56,34,20,31,5,26,52,50.0,26,32,9,23,19,75,24,3,Youssouf FofanaMilan
Heidenheim,Jonas Fohrenbach,917,de GER,DF,de Bundesliga,28,1996,20.4,45,24,25,15,5,22,35,62.9,13,29,3,26,16,61,57,0,Jonas FohrenbachHeidenheim
Fiorentina,Michael Folorunsho,918,it ITA,"FW,MF",it Serie A,26,1998,7.2,19,12,9,6,4,8,20,40.0,12,9,1,8,4,23,10,0,Michael FolorunshoFiorentina
Napoli,Michael Folorunsho,919,it ITA,"FW,MF",it Serie A,26,1998,0.4,3,2,0,3,0,2,4,50.0,2,0,0,0,1,4,1,1,Michael FolorunshoNapoli
Saint-Etienne,Lamine Fomba,920,fr FRA,MF,fr Ligue 1,26,1998,2.4,8,6,2,5,1,2,7,28.6,5,7,1,6,4,12,5,1,Lamine FombaSaint-Etienne
Wolves,Carlos Forbs,921,pt POR,"MF,FW",eng Premier League,20,2004,2.7,8,5,5,2,1,4,6,66.7,2,3,0,3,1,9,2,1,Carlos ForbsWolves
Betis,Pablo Fornals,922,es ESP,"MF,FW",es La Liga,28,1996,20.3,21,13,12,6,3,10,30,33.3,20,24,4,20,23,44,15,1,Pablo FornalsBetis
Monza,Omari Forson,923,eng ENG,"MF,FW",it Serie A,20,2004,2.5,3,3,1,2,0,1,3,33.3,2,3,0,3,1,4,1,0,Omari ForsonMonza
Tottenham,Fraser Forster,924,eng ENG,GK,eng Premier League,36,1988,7.0,0,0,0,0,0,0,1,0.0,1,0,0,0,0,0,7,3,Fraser ForsterTottenham
Barcelona,Hector Fort,925,es ESP,DF,es La Liga,17,2006,6.5,13,8,6,4,3,10,16,62.5,6,12,0,12,6,19,16,0,Hector FortBarcelona
Valencia,Dimitri Foulquier,926,fr FRA,DF,es La Liga,31,1993,25.5,48,31,29,13,6,24,36,66.7,12,21,5,16,16,64,86,1,Dimitri FoulquierValencia
Villarreal,Juan Foyth,927,ar ARG,DF,es La Liga,26,1998,16.9,25,15,15,6,4,11,16,68.8,5,26,17,9,19,44,119,3,Juan FoythVillarreal
Real Madrid,Fran,928,es ESP,GK,es La Liga,19,2005,1.0,0,0,0,0,0,0,0,,0,0,0,0,0,0,2,0,FranReal Madrid
Crystal Palace,Matheus Franca,929,br BRA,"MF,FW",eng Premier League,20,2004,0.6,2,0,0,2,0,0,0,,0,1,1,0,1,3,1,0,Matheus FrancaCrystal Palace
Girona,Alejandro Frances,930,es ESP,DF,es La Liga,21,2002,13.0,36,24,22,13,1,28,40,70.0,12,17,8,9,17,53,52,0,Alejandro FrancesGirona
Lens,Przemyslaw Frankowski,931,pl POL,DF,fr Ligue 1,29,1995,15.4,32,21,17,10,5,19,30,63.3,11,10,2,8,19,51,28,0,Przemyslaw FrankowskiLens
Leganes,Enric Franquesa,932,es ESP,"DF,FW",es La Liga,27,1997,6.8,17,9,9,6,2,9,13,69.2,4,7,1,6,5,22,12,0,Enric FranquesaLeganes
Southampton,Ryan Fraser,933,sct SCO,"FW,DF",eng Premier League,30,1994,3.4,6,2,2,4,0,4,6,66.7,2,1,1,0,1,7,9,0,Ryan FraserSouthampton
Inter,Davide Frattesi,934,it ITA,MF,it Serie A,24,1999,12.9,17,8,6,10,1,10,18,55.6,8,12,4,8,5,22,14,1,Davide FrattesiInter
Manchester Utd,Tyler Fredricson,935,eng ENG,DF,eng Premier League,19,2005,1.8,5,3,3,2,0,1,2,50.0,1,2,0,2,1,6,11,0,Tyler FredricsonManchester Utd
Genoa,Morten Frendrup,936,dk DEN,MF,it Serie A,23,2001,34.5,102,61,23,52,27,34,78,43.6,44,62,16,46,47,149,57,0,Morten FrendrupGenoa
Hellas Verona,Martin Frese,937,dk DEN,DF,it Serie A,26,1998,6.1,18,11,7,10,1,7,13,53.8,6,5,1,4,8,26,16,1,Martin FreseHellas Verona
Bologna,Remo Freuler,938,ch SUI,MF,it Serie A,32,1992,35.6,79,40,28,40,11,33,79,41.8,46,38,4,34,38,117,57,1,Remo FreulerBologna
Werder Bremen,Marco Friedl,939,at AUT,DF,de Bundesliga,26,1998,24.0,62,42,35,26,1,38,66,57.6,28,41,24,17,34,96,130,1,Marco FriedlWerder Bremen
Gladbach,Marvin Friedrich,940,de GER,DF,de Bundesliga,28,1995,11.0,15,9,12,3,0,9,16,56.3,7,16,12,4,5,20,57,0,Marvin FriedrichGladbach
Leverkusen,Jeremie Frimpong,941,nl NED,"DF,MF",de Bundesliga,23,2000,25.7,33,25,14,12,7,16,29,55.2,13,25,0,25,8,41,22,1,Jeremie FrimpongLeverkusen
Rayo Vallecano,Jorge de Frutos,942,es ESP,"FW,MF",es La Liga,27,1997,27.7,37,21,16,13,8,14,46,30.4,32,22,0,22,19,56,24,1,Jorge de FrutosRayo Vallecano
Sevilla,Dario Fuentes,943,es ESP,DF,es La Liga,21,2003,0.1,0,0,0,0,0,0,0,,0,0,0,0,0,0,0,0,Dario FuentesSevilla
Stuttgart,Chris Fuhrich,944,de GER,"MF,FW",de Bundesliga,26,1998,22.0,15,10,5,5,5,13,27,48.1,14,23,2,21,6,21,19,0,Chris FuhrichStuttgart
Gladbach,Shio Fukuda,945,jp JPN,FW,de Bundesliga,20,2004,0.7,0,0,0,0,0,0,0,,0,1,0,1,0,0,0,0,Shio FukudaGladbach
Lens,Angelo Fulgini,946,fr FRA,"MF,FW",fr Ligue 1,27,1996,11.6,14,10,6,4,4,6,16,37.5,10,11,1,10,2,16,3,0,Angelo FulginiLens
West Ham,Niclas Fullkrug,947,de GER,FW,eng Premier League,31,1993,8.8,4,3,0,1,3,3,4,75.0,1,1,0,1,1,5,16,0,Niclas FullkrugWest Ham
Rennes,Kyogo Furuhashi,948,jp JPN,FW,fr Ligue 1,29,1995,1.4,2,2,1,1,0,1,1,100.0,0,0,0,0,0,2,0,0,Kyogo FuruhashiRennes
Las Palmas,Manuel Fuster,949,es ESP,"FW,MF",es La Liga,26,1997,11.1,19,11,5,8,6,15,28,53.6,13,13,3,10,4,23,17,0,Manuel FusterLas Palmas
Milan,Matteo Gabbia,950,it ITA,DF,it Serie A,24,1999,23.9,21,15,13,7,1,8,10,80.0,2,25,19,6,15,36,103,1,Matteo GabbiaMilan
Torino,Tommaso Gabellini,951,it ITA,FW,it Serie A,17,2006,0.1,0,0,0,0,0,0,0,,0,0,0,0,0,0,0,0,Tommaso GabelliniTorino
Lecce,Tiago Gabriel,952,pt POR,DF,it Serie A,19,2004,1.1,0,0,0,0,0,0,0,,0,4,2,2,0,0,11,0,Tiago GabrielLecce
Como,Alessandro Gabrielloni,953,it ITA,"FW,MF",it Serie A,30,1994,1.6,0,0,0,0,0,0,3,0.0,3,0,0,0,0,0,1,0,Alessandro GabrielloniComo
Cagliari,Gianluca Gaetano,954,it ITA,"MF,FW",it Serie A,24,2000,11.2,11,8,4,6,1,5,15,33.3,10,8,0,8,6,17,8,0,Gianluca GaetanoCagliari
Monza,Roberto Gagliardini,955,it ITA,"MF,DF",it Serie A,30,1994,2.0,3,2,1,2,0,1,4,25.0,3,1,0,1,2,5,4,0,Roberto GagliardiniMonza
Liverpool,Cody Gakpo,956,nl NED,FW,eng Premier League,25,1999,21.5,28,16,6,13,9,13,25,52.0,12,23,3,20,12,40,19,1,Cody GakpoLiverpool
Atletico Madrid,Javi Galan,957,es ESP,DF,es La Liga,29,1994,19.8,51,31,31,15,5,25,49,51.0,24,13,3,10,12,63,47,0,Javi GalanAtletico Madrid
Athletic Club,Inigo Ruiz de Galarreta,958,es ESP,MF,es La Liga,30,1993,16.4,36,22,11,17,8,20,31,64.5,11,11,4,7,16,52,14,2,Inigo Ruiz de GalarretaAthletic Club
Atletico Madrid,Conor Gallagher,959,eng ENG,MF,es La Liga,24,2000,18.1,45,32,16,19,10,22,49,44.9,27,23,5,18,20,65,23,0,Conor GallagherAtletico Madrid
Lecce,Antonino Gallo,960,it ITA,DF,it Serie A,24,2000,29.0,65,42,46,15,4,34,62,54.8,28,33,6,27,20,85,133,0,Antonino GalloLecce
Rennes,Gauthier Gallon,961,fr FRA,GK,fr Ligue 1,31,1993,0.5,0,0,0,0,0,0,0,,0,0,0,0,0,0,0,0,Gauthier GallonRennes
Bochum,Cristian Gamboa,962,cr CRC,DF,de Bundesliga,34,1989,2.5,8,3,5,3,0,3,9,33.3,6,2,0,2,2,10,8,0,Cristian GamboaBochum
Everton,Idrissa Gana Gueye,963,sn SEN,MF,eng Premier League,34,1989,34.0,133,80,61,55,17,58,99,58.6,41,48,9,39,48,181,36,1,Idrissa Gana GueyeEverton
Nantes,Ignatius Ganago,964,cm CMR,"FW,MF",fr Ligue 1,25,1999,2.7,1,1,0,1,0,1,2,50.0,1,3,1,2,4,5,2,0,Ignatius GanagoNantes
Monza,Silvere Ganvoula M'Boussy,965,cg CGO,FW,it Serie A,28,1996,3.6,0,0,0,0,0,0,1,0.0,1,1,0,1,1,1,5,0,Silvere Ganvoula M'BoussyMonza
Alaves,Facundo Garces,966,my MAS,DF,es La Liga,24,1999,7.5,6,2,4,2,0,3,5,60.0,2,8,6,2,5,11,51,0,Facundo GarcesAlaves
Leverkusen,Aleix Garcia,967,es ESP,MF,de Bundesliga,27,1997,16.2,13,7,4,6,3,7,15,46.7,8,12,2,10,11,24,24,1,Aleix GarciaLeverkusen
Rayo Vallecano,Alvaro Garcia,968,es ESP,"FW,MF",es La Liga,31,1992,28.4,33,24,19,8,6,12,31,38.7,19,31,0,31,32,65,42,1,Alvaro GarciaRayo Vallecano
Aston Villa,Andres Garcia,969,es ESP,"DF,MF",eng Premier League,21,2003,3.5,9,5,5,3,1,4,8,50.0,4,2,0,2,2,11,10,2,Andres GarciaAston Villa
Barcelona,Eric Garcia,970,es ESP,"DF,MF",es La Liga,23,2001,17.4,38,21,11,24,3,20,29,69.0,9,24,8,16,14,52,41,0,Eric GarciaBarcelona
Real Madrid,Fran Garcia,971,es ESP,DF,es La Liga,24,1999,24.1,51,36,29,16,6,28,51,54.9,23,27,5,22,28,79,67,1,Fran GarciaReal Madrid
Real Madrid,Gonzalo Garcia,972,es ESP,"FW,DF",es La Liga,20,2004,0.6,0,0,0,0,0,0,0,,0,1,0,1,0,0,0,0,Gonzalo GarciaReal Madrid
Espanyol,Joan Garcia,973,es ESP,GK,es La Liga,23,2001,38.0,0,0,0,0,0,0,1,0.0,1,1,0,1,0,0,18,4,Joan GarciaEspanyol
Betis,Pablo Garcia,974,es ESP,FW,es La Liga,17,2006,0.4,0,0,0,0,0,0,0,,0,1,0,1,0,0,0,0,Pablo GarciaBetis
Osasuna,Ruben Garcia,975,es ESP,"FW,MF",es La Liga,31,1993,26.8,52,31,20,21,11,26,60,43.3,34,37,3,34,15,67,34,1,Ruben GarciaOsasuna
Marseille,Ulisses Garcia,976,ch SUI,DF,fr Ligue 1,28,1996,10.3,14,11,7,5,2,4,14,28.6,10,5,1,4,8,22,18,0,Ulisses GarciaMarseille
Osasuna,Unai Garcia,977,es ESP,DF,es La Liga,32,1992,0.7,0,0,0,0,0,0,0,,0,1,0,1,0,0,1,0,Unai GarciaOsasuna
Manchester Utd,Alejandro Garnacho,978,ar ARG,"MF,FW",eng Premier League,20,2004,24.4,30,18,11,6,13,12,37,32.4,25,19,0,19,13,43,11,2,Alejandro GarnachoManchester Utd
Everton,James Garner,979,eng ENG,"MF,DF",eng Premier League,23,2001,17.7,47,31,25,20,2,24,41,58.5,17,20,4,16,23,70,37,0,James GarnerEverton
Valencia,Yarek Gasiorowski,980,es ESP,DF,es La Liga,19,2005,10.5,19,16,16,3,0,9,13,69.2,4,17,6,11,26,45,60,0,Yarek GasiorowskiValencia
Juventus,Federico Gatti,981,it ITA,DF,it Serie A,26,1998,24.4,28,23,18,8,2,14,24,58.3,10,27,18,9,18,46,76,2,Federico GattiJuventus
Barcelona,Gavi,982,es ESP,"MF,FW",es La Liga,19,2004,12.1,30,21,10,15,5,15,26,57.7,11,14,1,13,10,40,7,0,GaviBarcelona
Girona,Paulo Gazzaniga,983,ar ARG,GK,es La Liga,32,1992,35.5,1,1,1,0,0,1,1,100.0,0,1,0,1,0,1,17,3,Paulo GazzanigaGirona
Nantes,Jean-Philippe Gbamin,984,ci CIV,MF,fr Ligue 1,28,1995,2.4,2,1,0,2,0,1,4,25.0,3,5,2,3,3,5,2,0,Jean-Philippe GbaminNantes
Reims,Mory Gbane,985,ci CIV,"DF,MF",fr Ligue 1,23,2000,12.5,20,11,16,4,0,13,24,54.2,11,12,10,2,18,38,90,1,Mory GbaneReims
Toulouse,Yann Gboho,986,fr FRA,"MF,FW",fr Ligue 1,23,2001,25.9,31,18,7,15,9,14,35,40.0,21,20,0,20,6,37,4,1,Yann GbohoToulouse
Fiorentina,David de Gea,987,es ESP,GK,it Serie A,33,1990,34.0,1,0,1,0,0,1,1,100.0,0,0,0,0,0,1,12,0,David de GeaFiorentina
RB Leipzig,Viggo Gebel,988,de GER,MF,de Bundesliga,16,2007,0.2,0,0,0,0,0,0,0,,0,0,0,0,0,0,0,0,Viggo GebelRB Leipzig
RB Leipzig,Lutsharel Geertruida,989,nl NED,DF,de Bundesliga,24,2000,17.3,35,24,24,11,0,15,31,48.4,16,15,4,11,16,51,59,4,Lutsharel GeertruidaRB Leipzig
Hoffenheim,Dennis Geiger,990,de GER,"MF,FW",de Bundesliga,26,1998,8.2,24,11,9,13,2,12,19,63.2,7,15,2,13,7,31,6,1,Dennis GeigerHoffenheim
Lecce,Valentin Gendrey,991,fr FRA,DF,it Serie A,24,2000,2.0,2,2,1,0,1,1,1,100.0,0,3,1,2,2,4,1,0,Valentin GendreyLecce
Hoffenheim,Valentin Gendrey,992,fr FRA,DF,de Bundesliga,24,2000,15.7,30,12,19,9,2,11,18,61.1,7,19,5,14,15,45,53,0,Valentin GendreyHoffenheim
Toulouse,Denis Genreau,993,au AUS,MF,fr Ligue 1,25,1999,2.5,7,5,4,1,2,4,8,50.0,4,3,0,3,3,10,4,0,Denis GenreauToulouse
Chelsea,Tyrique George,994,eng ENG,FW,eng Premier League,18,2006,2.0,2,0,2,0,0,2,3,66.7,1,1,0,1,2,4,1,0,Tyrique GeorgeChelsea
Wolfsburg,Yannick Gerhardt,995,de GER,"MF,DF",de Bundesliga,30,1994,16.9,28,16,13,14,1,11,30,36.7,19,32,8,24,17,45,47,0,Yannick GerhardtWolfsburg
Holstein Kiel,Max Geschwill,996,de GER,DF,de Bundesliga,23,2001,14.2,26,21,13,12,1,14,19,73.7,5,14,9,5,30,56,53,1,Max GeschwillHolstein Kiel
Hellas Verona,Daniele Ghilardi,997,it ITA,DF,it Serie A,21,2003,22.5,44,29,27,17,0,25,41,61.0,16,29,15,14,30,74,106,0,Daniele GhilardiHellas Verona
Udinese,Lautaro Gianetti,998,ar ARG,DF,it Serie A,30,1993,9.8,22,10,16,5,1,14,20,70.0,6,20,10,10,15,37,49,1,Lautaro GianettiUdinese
Augsburg,Dimitris Giannoulis,999,gr GRE,DF,de Bundesliga,28,1995,29.4,47,32,27,16,4,26,44,59.1,18,49,11,38,47,94,75,0,Dimitris GiannoulisAugsburg
Nott'ham Forest,Morgan Gibbs-White,1000,eng ENG,MF,eng Premier League,24,2000,31.1,43,22,14,23,6,17,33,51.5,16,18,5,13,23,66,29,1,Morgan Gibbs-WhiteNott'ham Forest
Lazio,Samuel Gigot,1001,fr FRA,DF,it Serie A,30,1993,7.6,4,3,1,3,0,0,1,0.0,1,8,6,2,13,17,36,0,Samuel GigotLazio
Holstein Kiel,Armin Gigovic,1002,ba BIH,MF,de Bundesliga,22,2002,21.1,25,13,14,8,3,5,21,23.8,16,20,1,19,21,46,33,0,Armin GigovicHolstein Kiel
Girona,Bryan Gil,1003,es ESP,"FW,MF",es La Liga,23,2001,19.1,34,20,10,15,9,14,30,46.7,16,24,0,24,10,44,9,4,Bryan GilGirona
Lazio,Mario Gila,1004,es ESP,DF,it Serie A,23,2000,30.5,55,37,35,18,2,37,56,66.1,19,20,13,7,28,83,115,4,Mario GilaLazio
Brighton,Billy Gilmour,1005,sct SCO,MF,eng Premier League,23,2001,1.1,3,3,2,1,0,3,4,75.0,1,1,0,1,0,3,1,0,Billy GilmourBrighton
Napoli,Billy Gilmour,1006,sct SCO,MF,it Serie A,23,2001,13.1,24,16,10,9,5,12,20,60.0,8,6,1,5,9,33,23,0,Billy GilmourNapoli
Heidenheim,Benedikt Gimber,1007,de GER,DF,de Bundesliga,27,1997,29.7,72,46,48,23,1,38,63,60.3,25,53,19,34,31,103,131,1,Benedikt GimberHeidenheim
Milan,Santiago Gimenez,1008,mx MEX,FW,it Serie A,23,2001,7.4,5,3,0,4,1,3,4,75.0,1,3,1,2,1,6,13,0,Santiago GimenezMilan
Torino,Gvidas Gineitis,1009,lt LTU,MF,it Serie A,20,2004,15.9,25,15,8,10,7,13,25,52.0,12,16,6,10,18,43,32,0,Gvidas GineitisTorino
Freiburg,Matthias Ginter,1010,de GER,DF,de Bundesliga,30,1994,28.5,30,17,15,11,4,15,28,53.6,13,35,23,12,19,49,146,5,Matthias GinterFreiburg
Dortmund,Jamie Gittens,1011,eng ENG,"FW,MF",de Bundesliga,19,2004,19.7,31,19,12,12,7,14,18,77.8,4,16,0,16,10,41,4,0,Jamie GittensDortmund
Bayern Munich,Serge Gnabry,1012,de GER,"FW,MF",de Bundesliga,29,1995,13.8,20,11,6,7,7,8,12,66.7,4,11,0,11,6,26,9,0,Serge GnabryBayern Munich
Ipswich Town,Ben Godfrey,1013,eng ENG,DF,eng Premier League,26,1998,1.8,1,0,1,0,0,1,1,100.0,0,1,1,0,2,3,3,0,Ben GodfreyIpswich Town
Atalanta,Ben Godfrey,1014,eng ENG,DF,it Serie A,26,1998,0.3,0,0,0,0,0,0,1,0.0,1,1,1,0,0,0,0,0,Ben GodfreyAtalanta
Fulham,Martial Godo,1015,eng ENG,"FW,DF",eng Premier League,21,2003,0.3,0,0,0,0,0,0,0,,0,1,0,1,1,1,0,0,Martial GodoFulham
Empoli,Saba Goglichidze,1016,ge GEO,DF,it Serie A,20,2004,28.2,64,37,36,25,3,25,51,49.0,26,36,17,19,33,97,97,3,Saba GoglichidzeEmpoli
Como,Edoardo Goldaniga,1017,it ITA,DF,it Serie A,30,1993,28.1,34,21,21,8,5,13,18,72.2,5,21,10,11,33,67,102,3,Edoardo GoldanigaComo
Leicester City,Michael Golding,1018,eng ENG,MF,eng Premier League,18,2006,0.0,0,0,0,0,0,0,0,,0,0,0,0,0,0,0,0,Michael GoldingLeicester City
Genoa,Pierluigi Gollini,1019,it ITA,GK,it Serie A,29,1995,7.0,0,0,0,0,0,0,0,,0,1,0,1,0,0,2,1,Pierluigi GolliniGenoa
Monaco,Aleksandr Golovin,1020,ru RUS,"MF,FW",fr Ligue 1,28,1996,12.8,38,24,9,20,9,17,39,43.6,22,16,4,12,12,50,7,0,Aleksandr GolovinMonaco
Lille,Andre Gomes,1021,pt POR,MF,fr Ligue 1,31,1993,14.2,27,13,9,11,7,11,31,35.5,20,7,1,6,6,33,11,2,Andre GomesLille
Lille,Angel Gomes,1022,eng ENG,MF,fr Ligue 1,23,2000,8.2,10,6,4,4,2,2,12,16.7,10,0,0,0,0,10,2,0,Angel GomesLille
Wolves,Joao Gomes,1023,br BRA,MF,eng Premier League,23,2001,33.0,116,71,55,53,8,48,110,43.6,62,42,4,38,25,141,33,0,Joao GomesWolves
Wolves,Rodrigo Gomes,1024,pt POR,"DF,FW",eng Premier League,21,2003,9.0,23,15,14,9,0,12,21,57.1,9,8,1,7,7,30,20,1,Rodrigo GomesWolves
Wolves,Toti Gomes,1025,pt POR,DF,eng Premier League,25,1999,29.0,61,43,42,15,4,37,46,80.4,9,29,17,12,25,86,152,5,Toti GomesWolves
Rennes,Carlos Gomez,1026,co COL,"MF,DF",fr Ligue 1,21,2002,4.2,8,6,3,4,1,3,9,33.3,6,6,0,6,2,10,2,0,Carlos GomezRennes
Valencia,Dani Gomez,1027,es ESP,FW,es La Liga,26,1998,5.9,3,2,0,0,3,0,0,,0,1,0,1,2,5,4,0,Dani GomezValencia
Brighton,Diego Gomez,1028,py PAR,MF,eng Premier League,21,2003,5.7,21,13,11,8,2,12,22,54.5,10,13,0,13,8,29,10,1,Diego GomezBrighton
Liverpool,Joe Gomez,1029,eng ENG,DF,eng Premier League,27,1997,5.8,13,10,5,7,1,11,16,68.8,5,9,6,3,7,20,20,2,Joe GomezLiverpool
Osasuna,Moi Gomez,1030,es ESP,"MF,FW",es La Liga,30,1994,8.8,13,9,4,7,2,4,8,50.0,4,5,2,3,6,19,7,1,Moi GomezOsasuna
Espanyol,Sergi Gomez,1031,es ESP,DF,es La Liga,32,1992,7.4,8,5,7,1,0,2,3,66.7,1,12,8,4,7,15,38,0,Sergi GomezEspanyol
Real Sociedad,Sergio Gomez,1032,es ESP,"MF,DF",es La Liga,23,2000,30.4,71,39,30,29,12,30,56,53.6,26,44,3,41,19,90,30,2,Sergio GomezReal Sociedad
Athletic Club,Unai Gomez,1033,es ESP,"MF,FW",es La Liga,21,2003,14.3,12,8,3,7,2,4,7,57.1,3,13,1,12,2,14,15,1,Unai GomezAthletic Club
RB Leipzig,Tidiam Gomis,1034,fr FRA,"MF,FW",de Bundesliga,17,2006,1.7,0,0,0,0,0,0,0,,0,2,0,2,1,1,0,0,Tidiam GomisRB Leipzig
Las Palmas,Fabio Gonzalez,1035,es ESP,MF,es La Liga,27,1997,0.6,0,0,0,0,0,0,1,0.0,1,0,0,0,0,0,0,0,Fabio GonzalezLas Palmas
Manchester City,Nicolas Gonzalez,1036,es ESP,MF,eng Premier League,22,2002,8.4,16,6,5,7,4,6,11,54.5,5,9,0,9,8,24,21,0,Nicolas GonzalezManchester City
Juventus,Nicolas Gonzalez,1037,ar ARG,"FW,MF",it Serie A,26,1998,19.4,24,13,10,9,5,9,25,36.0,16,16,4,12,9,33,37,2,Nicolas GonzalezJuventus
Getafe,Peter Gonzalez,1038,do DOM,"MF,FW",es La Liga,22,2002,5.3,11,6,2,5,4,6,9,66.7,3,8,0,8,2,13,5,0,Peter GonzalezGetafe
Espanyol,Urko Gonzalez,1039,es ESP,MF,es La Liga,23,2001,15.3,46,28,24,21,1,28,44,63.6,16,27,12,15,8,54,39,1,Urko GonzalezEspanyol
Real Sociedad,Urko Gonzalez,1040,es ESP,MF,es La Liga,23,2001,0.5,0,0,0,0,0,0,0,,0,1,1,0,0,0,0,0,Urko GonzalezReal Sociedad
Newcastle Utd,Anthony Gordon,1041,eng ENG,"FW,MF",eng Premier League,23,2001,27.0,32,18,9,18,5,12,37,32.4,25,25,2,23,7,39,9,3,Anthony GordonNewcastle Utd
Bayern Munich,Leon Goretzka,1042,de GER,"MF,DF",de Bundesliga,29,1995,14.7,21,11,5,12,4,10,20,50.0,10,27,7,20,20,41,25,1,Leon GoretzkaBayern Munich
Le Havre,Mathieu Gorgelin,1043,fr FRA,GK,fr Ligue 1,33,1990,16.0,2,2,2,0,0,2,3,66.7,1,0,0,0,0,2,8,2,Mathieu GorgelinLe Havre
Athletic Club,Andoni Gorosabel,1044,es ESP,DF,es La Liga,27,1996,16.5,47,28,31,9,7,30,45,66.7,15,18,2,16,18,65,62,0,Andoni GorosabelAthletic Club
Fiorentina,Robin Gosens,1045,de GER,DF,it Serie A,30,1994,27.0,56,31,31,17,8,25,44,56.8,19,34,11,23,18,74,91,0,Robin GosensFiorentina
Union Berlin,Robin Gosens,1046,de GER,DF,de Bundesliga,30,1994,1.0,0,0,0,0,0,0,3,0.0,3,1,0,1,1,1,2,0,Robin GosensUnion Berlin
Eint Frankfurt,Mario Gotze,1047,de GER,"MF,FW",de Bundesliga,32,1992,17.1,41,28,18,20,3,15,36,41.7,21,15,1,14,7,48,8,0,Mario GotzeEint Frankfurt
Marseille,Amine Gouiri,1048,dz ALG,"FW,MF",fr Ligue 1,24,2000,11.6,5,5,0,1,4,2,3,66.7,1,9,0,9,1,6,1,0,Amine GouiriMarseille
Rennes,Amine Gouiri,1049,dz ALG,"MF,FW",fr Ligue 1,24,2000,11.5,9,6,4,4,1,2,8,25.0,6,8,0,8,2,11,5,0,Amine GouiriRennes
Roma,Lucas Gourna-Douath,1050,fr FRA,MF,it Serie A,20,2003,2.5,9,4,5,4,0,2,6,33.3,4,1,1,0,0,9,2,0,Lucas Gourna-DouathRoma
Augsburg,Jeffrey Gouweleeuw,1051,nl NED,DF,de Bundesliga,33,1991,32.7,50,28,25,21,4,27,40,67.5,13,34,15,19,35,85,183,0,Jeffrey GouweleeuwAugsburg
Wolfsburg,Kamil Grabara,1052,pl POL,GK,de Bundesliga,25,1999,28.7,0,0,0,0,0,0,2,0.0,2,1,0,1,0,0,16,2,Kamil GrabaraWolfsburg
Lens,Jonathan Gradit,1053,fr FRA,DF,fr Ligue 1,31,1992,23.5,44,23,22,19,3,23,40,57.5,17,27,12,15,25,69,122,2,Jonathan GraditLens
Espanyol,Jose Gragera,1054,es ESP,MF,es La Liga,23,2000,6.3,25,16,11,14,0,9,17,52.9,8,9,1,8,5,30,13,0,Jose GrageraEspanyol
Le Havre,Samuel Grandsir,1055,fr FRA,"MF,FW",fr Ligue 1,27,1996,0.9,5,5,0,3,2,2,3,66.7,1,2,0,2,0,5,0,0,Samuel GrandsirLe Havre
Empoli,Alberto Grassi,1056,it ITA,MF,it Serie A,29,1995,24.5,39,21,16,18,5,14,22,63.6,8,22,12,10,33,72,43,1,Alberto GrassiEmpoli
Liverpool,Ryan Gravenberch,1057,nl NED,MF,eng Premier League,22,2002,35.1,69,35,27,29,13,32,56,57.1,24,35,10,25,60,129,59,2,Ryan GravenberchLiverpool
Tottenham,Archie Gray,1058,eng ENG,"DF,MF",eng Premier League,18,2006,19.5,16,8,4,8,4,7,17,41.2,10,22,11,11,19,35,50,2,Archie GrayTottenham
Manchester City,Jack Grealish,1059,eng ENG,"FW,MF",eng Premier League,28,1995,8.0,9,5,4,2,3,2,5,40.0,3,12,2,10,2,11,6,1,Jack GrealishManchester City
Ipswich Town,Jacob Greaves,1060,eng ENG,DF,eng Premier League,23,2000,24.5,40,21,20,17,3,22,35,62.9,13,41,26,15,21,61,148,3,Jacob GreavesIpswich Town
Marseille,Mason Greenwood,1061,eng ENG,"FW,MF",fr Ligue 1,22,2001,31.2,35,18,10,14,11,16,39,41.0,23,7,0,7,12,47,5,2,Mason GreenwoodMarseille
Freiburg,Michael Gregoritsch,1062,at AUT,FW,de Bundesliga,30,1994,7.1,4,2,1,0,3,1,5,20.0,4,2,1,1,1,5,10,0,Michael GregoritschFreiburg
Mallorca,Dominik Greif,1063,sk SVK,GK,es La Liga,27,1997,31.0,0,0,0,0,0,0,0,,0,0,0,0,0,0,13,1,Dominik GreifMallorca
Atletico Madrid,Antoine Griezmann,1064,fr FRA,"FW,MF",es La Liga,33,1991,27.4,30,17,13,13,4,7,29,24.1,22,20,1,19,6,36,23,1,Antoine GriezmannAtletico Madrid
Freiburg,Vincenzo Grifo,1065,it ITA,"FW,MF",de Bundesliga,31,1993,27.0,30,22,12,13,5,15,34,44.1,19,24,2,22,9,39,23,2,Vincenzo GrifoFreiburg
Valladolid,Florian Grillitsch,1066,at AUT,MF,es La Liga,28,1995,6.9,11,7,7,3,1,7,15,46.7,8,12,2,10,4,15,5,1,Florian GrillitschValladolid
Hoffenheim,Florian Grillitsch,1067,at AUT,MF,de Bundesliga,28,1995,6.7,15,9,5,9,1,8,14,57.1,6,6,2,4,8,23,18,0,Florian GrillitschHoffenheim
Leverkusen,Alex Grimaldo,1068,es ESP,DF,de Bundesliga,28,1995,29.3,24,14,13,7,4,16,42,38.1,26,22,3,19,16,40,43,3,Alex GrimaldoLeverkusen
Dortmund,Pascal Gross,1069,de GER,"MF,DF",de Bundesliga,33,1991,25.9,44,28,11,26,7,15,51,29.4,36,46,13,33,9,53,30,1,Pascal GrossDortmund
Brighton,Brajan Gruda,1070,de GER,"MF,FW",eng Premier League,20,2004,7.6,16,8,6,6,4,7,14,50.0,7,8,0,8,2,18,5,1,Brajan GrudaBrighton
Werder Bremen,Marco Grull,1071,at AUT,"FW,MF",de Bundesliga,26,1998,13.1,12,9,1,5,6,4,17,23.5,13,14,2,12,3,15,10,0,Marco GrullWerder Bremen
Southampton,Albert Gronbaek,1072,dk DEN,"FW,MF",eng Premier League,23,2001,1.6,4,1,1,1,2,3,10,30.0,7,1,1,0,0,4,1,0,Albert GronbaekSouthampton
Rennes,Albert Gronbaek,1073,dk DEN,"MF,FW",fr Ligue 1,23,2001,9.0,21,11,10,7,4,10,28,35.7,18,9,1,8,4,25,6,0,Albert GronbaekRennes
Celta Vigo,Vicente Guaita,1074,es ESP,GK,es La Liga,37,1987,34.0,0,0,0,0,0,0,0,,0,0,0,0,0,0,21,3,Vicente GuaitaCelta Vigo
Rayo Vallecano,Sergi Guardiola,1075,es ESP,FW,es La Liga,33,1991,4.0,5,3,0,5,0,2,3,66.7,1,1,0,1,1,6,2,0,Sergi GuardiolaRayo Vallecano
Sevilla,Nemanja Gudelj,1076,rs SRB,"MF,DF",es La Liga,32,1991,27.7,42,24,16,22,4,21,35,60.0,14,27,10,17,27,69,94,1,Nemanja GudeljSevilla
Lille,Gabriel Gudmundsson,1077,se SWE,DF,fr Ligue 1,25,1999,19.8,36,25,15,15,6,23,36,63.9,13,19,7,12,17,53,41,3,Gabriel GudmundssonLille
Wolves,Goncalo Guedes,1078,pt POR,"MF,FW",eng Premier League,27,1996,11.1,16,5,2,6,8,4,16,25.0,12,11,0,11,5,21,4,0,Goncalo GuedesWolves
Montpellier,Axel Gueguin,1079,fr FRA,FW,fr Ligue 1,19,2005,0.3,1,1,0,1,0,1,1,100.0,0,0,0,0,0,1,0,0,Axel GueguinMontpellier
Crystal Palace,Marc Guehi,1080,eng ENG,DF,eng Premier League,24,2000,34.0,61,34,36,23,2,31,47,66.0,16,55,23,32,28,89,163,2,Marc GuehiCrystal Palace
Lazio,Matteo Guendouzi,1081,fr FRA,MF,it Serie A,25,1999,36.3,37,21,13,19,5,20,47,42.6,27,34,9,25,32,69,50,2,Matteo GuendouziLazio
Valencia,Javier Guerra,1082,es ESP,MF,es La Liga,21,2003,28.7,50,27,18,21,11,26,56,46.4,30,15,3,12,20,70,49,3,Javier GuerraValencia
Bayern Munich,Raphael Guerreiro,1083,pt POR,"DF,MF",de Bundesliga,30,1993,17.5,19,12,9,7,3,12,16,75.0,4,9,0,9,10,29,19,1,Raphael GuerreiroBayern Munich
Nice,Evann Guessand,1084,ci CIV,"FW,MF",fr Ligue 1,23,2001,28.5,44,29,12,15,17,6,14,42.9,8,27,3,24,15,59,16,0,Evann GuessandNice
Alaves,Ander Guevara,1085,es ESP,MF,es La Liga,27,1997,21.6,49,30,19,29,1,20,48,41.7,28,21,5,16,14,63,43,1,Ander GuevaraAlaves
Villarreal,Pape Gueye,1086,sn SEN,MF,es La Liga,25,1999,24.7,54,26,23,23,8,20,29,69.0,9,31,13,18,27,81,53,2,Pape GueyeVillarreal
St. Pauli,Morgan Guilavogui,1087,gn GUI,"FW,MF",de Bundesliga,26,1998,20.1,32,17,11,16,5,14,31,45.2,17,28,0,28,13,45,33,0,Morgan GuilavoguiSt. Pauli
Lecce,Frederic Guilbert,1088,fr FRA,DF,it Serie A,29,1994,27.1,65,36,30,29,6,36,55,65.5,19,28,8,20,47,112,113,3,Frederic GuilbertLecce
West Ham,Luis Guilherme,1089,br BRA,"MF,FW",eng Premier League,18,2006,1.7,1,0,1,0,0,0,3,0.0,3,7,0,7,3,4,2,0,Luis GuilhermeWest Ham
Valencia,Hugo Guillamon,1090,es ESP,MF,es La Liga,24,2000,4.0,11,8,1,9,1,9,10,90.0,1,4,1,3,5,16,9,1,Hugo GuillamonValencia
Newcastle Utd,Bruno Guimaraes,1091,br BRA,MF,eng Premier League,26,1997,36.3,83,47,41,30,12,33,69,47.8,36,36,10,26,29,112,44,5,Bruno GuimaraesNewcastle Utd
Betis,Carlos Guirao,1092,es ESP,MF,es La Liga,21,2003,1.2,5,3,1,4,0,4,6,66.7,2,1,1,0,3,8,2,0,Carlos GuiraoBetis
Nantes,Bahereba Guirassy,1093,fr FRA,"FW,MF",fr Ligue 1,17,2006,3.9,12,8,6,3,3,7,13,53.8,6,10,0,10,1,13,4,0,Bahereba GuirassyNantes
Dortmund,Serhou Guirassy,1094,gn GUI,FW,de Bundesliga,28,1996,28.9,7,6,2,2,3,2,5,40.0,3,10,3,7,4,11,38,0,Serhou GuirassyDortmund
Chelsea,Marc Guiu,1095,es ESP,FW,eng Premier League,18,2006,0.8,1,1,0,1,0,1,1,100.0,0,0,0,0,0,1,0,0,Marc GuiuChelsea
RB Leipzig,Peter Gulacsi,1096,hu HUN,GK,de Bundesliga,34,1990,29.2,1,1,1,0,0,1,2,50.0,1,0,0,0,0,1,16,4,Peter GulacsiRB Leipzig
Real Madrid,Arda Guler,1097,tr TUR,"MF,FW",es La Liga,19,2005,13.9,30,16,11,8,11,9,22,40.9,13,18,0,18,7,37,8,0,Arda GulerReal Madrid
Rayo Vallecano,Gerard Gumbau,1098,es ESP,MF,es La Liga,29,1994,9.4,17,12,8,7,2,7,15,46.7,8,13,4,9,5,22,13,0,Gerard GumbauRayo Vallecano
Augsburg,Robert Gumny,1099,pl POL,DF,de Bundesliga,26,1998,3.0,3,3,1,2,0,2,6,33.3,4,2,0,2,1,4,6,0,Robert GumnyAugsburg
Manchester City,Ilkay Gundogan,1100,de GER,MF,eng Premier League,33,1990,24.7,25,13,5,15,5,10,24,41.7,14,15,0,15,13,38,23,0,Ilkay GundoganManchester City
Freiburg,Christian Gunter,1101,de GER,DF,de Bundesliga,31,1993,25.7,23,21,12,8,3,16,29,55.2,13,24,10,14,8,31,50,1,Christian GunterFreiburg
Alaves,Jon Guridi,1102,es ESP,"MF,FW",es La Liga,29,1995,23.1,40,22,7,26,7,18,44,40.9,26,19,1,18,14,54,16,0,Jon GuridiAlaves
Athletic Club,Gorka Guruzeta,1103,es ESP,FW,es La Liga,27,1996,20.4,16,8,1,13,2,7,31,22.6,24,28,4,24,9,25,23,0,Gorka GuruzetaAthletic Club
Chelsea,Malo Gusto,1104,fr FRA,DF,eng Premier League,21,2003,20.7,45,29,27,15,3,25,48,52.1,23,29,8,21,24,69,49,5,Malo GustoChelsea
Girona,Miguel Gutierrez,1105,es ESP,"DF,MF",es La Liga,23,2001,27.3,37,24,18,16,3,17,37,45.9,20,17,7,10,16,53,34,3,Miguel GutierrezGirona
Fiorentina,Albert Gudmundsson,1106,is ISL,"FW,MF",it Serie A,27,1997,14.1,9,5,2,4,3,7,17,41.2,10,5,0,5,6,15,9,1,Albert GudmundssonFiorentina
Manchester City,Josko Gvardiol,1107,hr CRO,DF,eng Premier League,22,2002,36.4,58,39,25,21,12,21,40,52.5,19,42,20,22,44,102,122,8,Josko GvardiolManchester City
Empoli,Emmanuel Gyasi,1108,gh GHA,"DF,FW",it Serie A,30,1994,35.7,52,29,32,14,6,24,38,63.2,14,27,9,18,11,63,77,0,Emmanuel GyasiEmpoli
Venezia,Christian Gytkjaer,1109,dk DEN,FW,it Serie A,34,1990,8.4,6,4,2,2,2,1,2,50.0,1,3,1,2,0,6,8,0,Christian GytkjaerVenezia
Manchester City,Erling Haaland,1110,no NOR,FW,eng Premier League,24,2000,30.4,11,6,3,3,5,3,8,37.5,5,12,1,11,5,16,23,0,Erling HaalandManchester City
Empoli,Nicolas Haas,1111,ch SUI,MF,it Serie A,28,1996,3.2,11,8,4,5,2,5,9,55.6,4,2,1,1,4,15,6,0,Nicolas HaasEmpoli
Union Berlin,Janik Haberer,1112,de GER,"MF,DF",de Bundesliga,30,1994,18.8,39,29,16,21,2,26,44,59.1,18,16,0,16,17,56,37,0,Janik HabererUnion Berlin
Gladbach,Robin Hack,1113,de GER,"FW,MF",de Bundesliga,25,1998,24.1,22,17,11,8,3,12,28,42.9,16,30,2,28,9,31,28,0,Robin HackGladbach
Venezia,Saad El Haddad,1114,ma MAR,MF,it Serie A,19,2005,0.3,0,0,0,0,0,0,0,,0,0,0,0,0,0,0,0,Saad El HaddadVenezia
Leganes,Munir El Haddadi,1115,ma MAR,"FW,MF",es La Liga,28,1995,9.6,12,9,5,4,3,3,12,25.0,9,8,1,7,1,13,1,1,Munir El HaddadiLeganes
RB Leipzig,Amadou Haidara,1116,ml MLI,MF,de Bundesliga,26,1998,14.7,30,17,12,16,2,12,29,41.4,17,42,12,30,18,48,56,1,Amadou HaidaraRB Leipzig
Brest,Massadio Haidara,1117,ml MLI,DF,fr Ligue 1,31,1992,18.6,27,16,16,9,2,13,29,44.8,16,18,2,16,26,53,73,0,Massadio HaidaraBrest
Parma,Antoine Hainaut,1118,fr FRA,"DF,FW",it Serie A,22,2002,13.4,26,14,15,8,3,9,13,69.2,4,17,4,13,15,41,59,1,Antoine HainautParma
Parma,Mohamed Haj,1119,tn TUN,MF,it Serie A,19,2005,5.0,3,1,2,1,0,1,2,50.0,1,3,1,2,4,7,5,0,Mohamed HajParma
Paris S-G,Achraf Hakimi,1120,ma MAR,DF,fr Ligue 1,25,1998,23.0,48,36,18,20,10,27,55,49.1,28,25,2,23,31,79,18,3,Achraf HakimiParis S-G
Newcastle Utd,Lewis Hall,1121,eng ENG,DF,eng Premier League,19,2004,24.3,58,41,28,22,8,40,74,54.1,34,33,18,15,18,76,75,3,Lewis HallNewcastle Utd
Leganes,Sebastien Haller,1122,ci CIV,FW,es La Liga,30,1994,4.5,2,0,1,0,1,1,2,50.0,1,1,0,1,0,2,7,0,Sebastien HallerLeganes
Ipswich Town,Ali Al Hamadi,1123,iq IRQ,FW,eng Premier League,22,2002,1.5,1,0,0,0,1,0,2,0.0,2,0,0,0,0,1,2,0,Ali Al HamadiIpswich Town
Mainz 05,Andreas Hanche-Olsen,1124,no NOR,DF,de Bundesliga,27,1997,14.3,21,13,12,8,1,9,12,75.0,3,25,18,7,12,33,85,2,Andreas Hanche-OlsenMainz 05
Angers,Florent Hanin,1125,dz ALG,DF,fr Ligue 1,34,1990,29.7,69,48,45,17,7,39,71,54.9,32,31,10,21,47,116,99,2,Florent HaninAngers
Venezia,Ridgeciano Haps,1126,sr SUR,DF,it Serie A,31,1993,15.2,30,16,19,8,3,14,22,63.6,8,18,3,15,7,37,48,0,Ridgeciano HapsVenezia
Marseille,Amine Harit,1127,ma MAR,MF,fr Ligue 1,27,1997,5.8,8,7,0,6,2,1,2,50.0,1,6,0,6,3,11,1,1,Amine HaritMarseille
Ipswich Town,Marcus Harness,1128,eng ENG,MF,eng Premier League,28,1996,0.5,1,0,0,0,1,0,3,0.0,3,2,1,1,0,1,1,0,Marcus HarnessIpswich Town
Holstein Kiel,Phil Harres,1129,de GER,FW,de Bundesliga,22,2002,17.2,10,10,3,4,3,4,8,50.0,4,17,3,14,5,15,20,0,Phil HarresHolstein Kiel
Everton,Jack Harrison,1130,eng ENG,FW,eng Premier League,27,1996,23.1,32,22,12,12,8,15,46,32.6,31,18,2,16,10,42,35,2,Jack HarrisonEverton
Hellas Verona,Abdou Harroui,1131,nl NED,"MF,FW",it Serie A,26,1998,5.1,9,6,6,3,0,4,4,100.0,0,5,0,5,2,11,5,0,Abdou HarrouiHellas Verona
Southampton,Taylor Harwood-Bellis,1132,eng ENG,DF,eng Premier League,22,2002,31.4,28,20,13,12,3,19,35,54.3,16,65,43,22,30,58,141,6,Taylor Harwood-BellisSouthampton
Rennes,Hans Hateboer,1133,nl NED,DF,fr Ligue 1,30,1994,18.7,31,16,14,12,5,18,36,50.0,18,19,6,13,29,60,64,2,Hans HateboerRennes
Toulouse,Kjetil Haug,1134,no NOR,GK,fr Ligue 1,26,1998,5.5,0,0,0,0,0,0,0,,0,0,0,0,0,0,3,0,Kjetil HaugToulouse
Arsenal,Kai Havertz,1135,de GER,"FW,MF",eng Premier League,25,1999,20.8,16,9,3,6,7,4,15,26.7,11,23,4,19,6,22,33,1,Kai HavertzArsenal
Manchester Utd,Ayden Heaven,1136,eng ENG,DF,eng Premier League,17,2006,1.9,4,3,1,3,0,2,2,100.0,0,2,2,0,4,8,9,0,Ayden HeavenManchester Utd
Brighton,Jan Paul van Hecke,1137,nl NED,DF,eng Premier League,24,2000,32.9,45,29,24,19,2,23,41,56.1,18,37,22,15,24,69,142,2,Jan Paul van HeckeBrighton
Wolves,Hwang Hee-chan,1138,kr KOR,"MF,FW",eng Premier League,28,1996,7.3,6,4,2,1,3,2,6,33.3,4,9,0,9,2,8,11,0,Hwang Hee-chanWolves
Crystal Palace,Dean Henderson,1139,eng ENG,GK,eng Premier League,27,1997,38.0,2,1,2,0,0,2,6,33.3,4,0,0,0,0,2,22,0,Dean HendersonCrystal Palace
Empoli,Liam Henderson,1140,sct SCO,MF,it Serie A,28,1996,26.0,42,22,17,22,3,22,53,41.5,31,19,5,14,15,57,42,0,Liam HendersonEmpoli
Stuttgart,Ramon Hendriks,1141,nl NED,DF,de Bundesliga,23,2001,12.8,20,9,11,7,2,9,13,69.2,4,15,7,8,19,39,63,0,Ramon HendriksStuttgart
Hoffenheim,Paul Hennrich,1142,de GER,MF,de Bundesliga,19,2005,0.1,0,0,0,0,0,0,0,,0,1,1,0,0,0,0,0,Paul HennrichHoffenheim
RB Leipzig,Benjamin Henrichs,1143,de GER,DF,de Bundesliga,27,1997,10.4,32,16,18,10,4,14,27,51.9,13,22,3,19,15,47,33,0,Benjamin HenrichsRB Leipzig
Valladolid,Henrique,1144,br BRA,DF,es La Liga,30,1994,3.9,6,2,3,2,1,1,4,25.0,3,5,0,5,3,9,12,0,HenriqueValladolid
Marseille,Luis Henrique,1145,br BRA,"DF,FW",fr Ligue 1,22,2001,29.0,16,9,7,6,3,9,10,90.0,1,15,2,13,10,26,30,0,Luis HenriqueMarseille
Brentford,Rico Henry,1146,eng ENG,DF,eng Premier League,27,1997,1.1,2,2,1,0,1,0,4,0.0,4,4,1,3,1,3,2,0,Rico HenryBrentford
Leicester City,Mads Hermansen,1147,dk DEN,GK,eng Premier League,24,2000,26.5,1,1,1,0,0,1,1,100.0,0,1,0,1,0,1,13,4,Mads HermansenLeicester City
Roma,Mario Hermoso,1148,es ESP,DF,it Serie A,29,1995,2.8,2,1,2,0,0,0,1,0.0,1,1,1,0,4,6,13,0,Mario HermosoRoma
Leverkusen,Mario Hermoso,1149,es ESP,DF,de Bundesliga,29,1995,3.3,0,0,0,0,0,0,0,,0,3,1,2,9,9,15,1,Mario HermosoLeverkusen
Leganes,Javi Hernandez,1150,es ESP,DF,es La Liga,26,1998,26.5,26,15,16,7,3,17,46,37.0,29,25,5,20,23,49,98,0,Javi HernandezLeganes
Rayo Vallecano,Aridane Hernandez,1151,es ESP,DF,es La Liga,35,1989,11.4,13,11,9,4,0,6,8,75.0,2,10,8,2,6,19,99,2,Aridane HernandezRayo Vallecano
Paris S-G,Lucas Hernandez,1152,fr FRA,DF,fr Ligue 1,28,1996,9.7,24,18,13,9,2,14,23,60.9,9,12,5,7,7,31,37,2,Lucas HernandezParis S-G
Milan,Theo Hernandez,1153,fr FRA,DF,it Serie A,26,1997,30.0,36,28,23,10,3,21,39,53.8,18,25,10,15,17,53,75,3,Theo HernandezMilan
Parma,Hernani,1154,br BRA,MF,it Serie A,30,1994,14.7,47,26,25,18,4,27,50,54.0,23,26,6,20,19,66,12,1,HernaniParma
Osasuna,Jorge Herrando,1155,es ESP,DF,es La Liga,23,2001,15.2,17,11,9,5,3,9,15,60.0,6,20,14,6,12,29,65,2,Jorge HerrandoOsasuna
Athletic Club,Ander Herrera,1156,es ESP,MF,es La Liga,34,1989,3.0,8,4,1,7,0,3,6,50.0,3,1,0,1,2,10,10,0,Ander HerreraAthletic Club
Osasuna,Sergio Herrera,1157,es ESP,GK,es La Liga,31,1993,37.0,2,1,2,0,0,2,6,33.3,4,1,0,1,0,2,29,1,Sergio HerreraOsasuna
Girona,Yangel Herrera,1158,ve VEN,MF,es La Liga,26,1998,25.1,66,39,31,27,8,30,59,50.8,29,24,8,16,31,97,50,2,Yangel HerreraGirona
Las Palmas,Juan Herzog,1159,es ESP,DF,es La Liga,21,2003,14.6,12,12,12,0,0,9,16,56.3,7,17,11,6,18,30,86,0,Juan HerzogLas Palmas
Tottenham,Son Heung-min,1160,kr KOR,FW,eng Premier League,32,1992,23.4,17,9,3,8,6,5,27,18.5,22,11,0,11,5,22,17,1,Son Heung-minTottenham
Atalanta,Isak Hien,1161,se SWE,DF,it Serie A,25,1999,25.9,48,28,27,21,0,27,44,61.4,17,31,18,13,31,79,82,2,Isak HienAtalanta
Espanyol,Omar El Hilali,1162,ma MAR,DF,es La Liga,20,2003,35.0,111,79,81,24,6,64,95,67.4,31,53,13,40,46,157,145,2,Omar El HilaliEspanyol
Bournemouth,James Hill,1163,eng ENG,DF,eng Premier League,22,2002,5.0,15,8,6,6,3,3,11,27.3,8,5,0,5,9,24,31,0,James HillBournemouth
Leverkusen,Piero Hincapie,1164,ec ECU,DF,de Bundesliga,22,2002,29.7,52,40,27,15,10,25,41,61.0,16,40,20,20,32,84,114,1,Piero HincapieLeverkusen
Espanyol,Roger Hinojo,1165,es ESP,DF,es La Liga,19,2005,0.1,0,0,0,0,0,0,0,,0,0,0,0,0,0,1,0,Roger HinojoEspanyol
Brighton,Jack Hinshelwood,1166,eng ENG,"MF,DF",eng Premier League,19,2005,20.5,27,19,8,10,9,11,27,40.7,16,10,3,7,16,43,37,1,Jack HinshelwoodBrighton
Ipswich Town,George Hirst,1167,sct SCO,FW,eng Premier League,25,1999,7.3,3,3,1,0,2,1,4,25.0,3,1,1,0,2,5,10,0,George HirstIpswich Town
Hoffenheim,Adam Hlozek,1168,cz CZE,"FW,MF",de Bundesliga,22,2002,20.8,22,10,7,8,7,11,20,55.0,9,13,1,12,4,26,20,0,Adam HlozekHoffenheim
Auxerre,Ki-Jana Hoever,1169,nl NED,DF,fr Ligue 1,22,2002,23.6,51,38,26,16,9,30,54,55.6,24,33,3,30,21,72,70,1,Ki-Jana HoeverAuxerre
Freiburg,Nicolas Hofler,1170,de GER,MF,de Bundesliga,34,1990,8.8,33,23,13,18,2,20,31,64.5,11,7,1,6,14,47,28,1,Nicolas HoflerFreiburg
Leverkusen,Jonas Hofmann,1171,de GER,"MF,DF",de Bundesliga,32,1992,4.0,2,0,0,2,0,1,4,25.0,3,2,0,2,0,2,3,0,Jonas HofmannLeverkusen
Bochum,Philipp Hofmann,1172,de GER,FW,de Bundesliga,31,1993,25.3,17,12,4,6,7,8,15,53.3,7,14,1,13,4,21,33,0,Philipp HofmannBochum
Freiburg,Lucas Holer,1173,de GER,"FW,MF",de Bundesliga,30,1994,20.7,37,24,18,15,4,9,24,37.5,15,29,7,22,7,44,36,0,Lucas HolerFreiburg
Everton,Mason Holgate,1174,jm JAM,"FW,DF",eng Premier League,27,1996,0.1,0,0,0,0,0,0,0,,0,0,0,0,0,0,0,0,Mason HolgateEverton
Union Berlin,Benedict Hollerbach,1175,de GER,"FW,MF",de Bundesliga,23,2001,28.2,43,22,8,23,12,21,51,41.2,30,35,0,35,2,45,13,1,Benedict HollerbachUnion Berlin
Bologna,Emil Holm,1176,se SWE,DF,it Serie A,24,2000,12.6,34,21,17,14,3,20,31,64.5,11,19,4,15,10,44,51,1,Emil HolmBologna
Holstein Kiel,Lewis Holtby,1177,de GER,MF,de Bundesliga,33,1990,13.8,34,20,19,10,5,12,28,42.9,16,14,2,12,21,55,26,3,Lewis HoltbyHolstein Kiel
Bochum,Gerrit Holtmann,1178,ph PHI,"DF,FW",de Bundesliga,29,1995,12.6,24,19,14,8,2,12,24,50.0,12,18,5,13,16,40,15,0,Gerrit HoltmannBochum
Gladbach,Franck Honorat,1179,fr FRA,FW,de Bundesliga,27,1996,16.0,17,7,10,4,3,2,8,25.0,6,9,1,8,5,22,28,1,Franck HonoratGladbach
Heidenheim,Mathias Honsak,1180,at AUT,"FW,DF",de Bundesliga,27,1996,13.1,15,8,10,5,0,10,23,43.5,13,19,4,15,10,25,31,0,Mathias HonsakHeidenheim
Las Palmas,Dinko Horkas,1181,hr CRO,GK,es La Liga,25,1999,12.1,0,0,0,0,0,0,0,,0,0,0,0,0,0,9,1,Dinko HorkasLas Palmas
Bochum,Timo Horn,1182,de GER,GK,de Bundesliga,31,1993,13.0,0,0,0,0,0,0,0,,0,0,0,0,0,0,9,2,Timo HornBochum
Angers,Cedric Hountondji,1183,bj BEN,DF,fr Ligue 1,30,1994,3.0,6,4,4,2,0,3,7,42.9,4,3,3,0,4,10,14,0,Cedric HountondjiAngers
Le Havre,Ilyes Housni,1184,fr FRA,"FW,MF",fr Ligue 1,19,2005,2.6,7,5,2,3,2,2,4,50.0,2,2,0,2,1,8,2,0,Ilyes HousniLe Havre
Brighton,Harry Howell,1185,eng ENG,FW,eng Premier League,15,2008,0.1,1,1,1,0,0,1,2,50.0,1,1,0,1,0,1,0,0,Harry HowellBrighton
Leverkusen,Lukas Hradecky,1186,fi FIN,GK,de Bundesliga,34,1989,29.0,0,0,0,0,0,0,1,0.0,1,0,0,0,0,0,8,2,Lukas HradeckyLeverkusen
Hoffenheim,Robin Hranac,1187,cz CZE,DF,de Bundesliga,24,2000,2.4,0,0,0,0,0,0,1,0.0,1,3,2,1,5,5,9,1,Robin HranacHoffenheim
Nott'ham Forest,Callum Hudson-Odoi,1188,eng ENG,"FW,MF",eng Premier League,23,2000,24.4,22,14,8,8,6,12,18,66.7,6,11,0,11,13,35,12,1,Callum Hudson-OdoiNott'ham Forest
Crystal Palace,Will Hughes,1189,eng ENG,MF,eng Premier League,29,1995,23.4,66,36,20,33,13,28,62,45.2,34,31,14,17,22,88,28,3,Will HughesCrystal Palace
Bournemouth,Dean Huijsen,1190,es ESP,DF,eng Premier League,19,2005,27.0,36,26,19,16,1,18,29,62.1,11,40,29,11,51,87,198,4,Dean HuijsenBournemouth
Roma,Mats Hummels,1191,de GER,DF,it Serie A,35,1988,10.2,30,15,16,14,0,11,18,61.1,7,12,4,8,26,56,43,0,Mats HummelsRoma
Ipswich Town,Omari Hutchinson,1192,eng ENG,"MF,FW",eng Premier League,20,2003,28.7,32,13,14,10,8,13,48,27.1,35,27,2,25,11,43,15,1,Omari HutchinsonIpswich Town
Lazio,Elseid Hysaj,1193,al ALB,DF,it Serie A,30,1994,4.7,11,6,6,5,0,3,3,100.0,0,5,2,3,5,16,21,0,Elseid HysajLazio
Mainz 05,Hong Hyunseok,1194,kr KOR,MF,de Bundesliga,25,1999,5.9,8,3,3,3,2,1,4,25.0,3,7,1,6,7,15,9,0,Hong HyunseokMainz 05
Marseille,Pierre Hojbjerg,1195,dk DEN,MF,fr Ligue 1,28,1995,29.6,64,45,25,32,7,37,69,53.6,32,28,4,24,42,106,33,2,Pierre HojbjergMarseille
Eint Frankfurt,Oscar Hojlund,1196,dk DEN,MF,de Bundesliga,19,2005,8.0,21,12,8,9,4,8,16,50.0,8,15,7,8,5,26,11,1,Oscar HojlundEint Frankfurt
Manchester Utd,Rasmus Hojlund,1197,dk DEN,FW,eng Premier League,21,2003,22.3,3,1,0,2,1,0,5,0.0,5,6,0,6,2,5,6,0,Rasmus HojlundManchester Utd
Osasuna,Pablo Ibanez,1198,es ESP,MF,es La Liga,25,1998,14.4,20,10,7,12,1,10,40,25.0,30,20,7,13,18,38,21,0,Pablo IbanezOsasuna
Reims,Hafiz Ibrahim,1199,ng NGA,FW,fr Ligue 1,18,2005,4.3,3,2,0,1,2,0,5,0.0,5,4,2,2,2,5,6,0,Hafiz IbrahimReims
Lazio,Arijon Ibrahimovic,1200,de GER,MF,it Serie A,18,2005,0.1,0,0,0,0,0,0,0,,0,0,0,0,0,0,0,0,Arijon IbrahimovicLazio
Bayern Munich,Arijon Ibrahimovic,1201,de GER,FW,de Bundesliga,18,2005,0.0,0,0,0,0,0,0,0,,0,0,0,0,0,0,0,0,Arijon IbrahimovicBayern Munich
Sevilla,Stanis Idumbo,1202,be BEL,"FW,MF",es La Liga,19,2005,3.2,9,5,3,4,2,3,5,60.0,2,3,1,2,4,13,2,0,Stanis IdumboSevilla
Venezia,Jay Idzes,1203,id IDN,DF,it Serie A,24,2000,34.7,45,29,24,17,4,17,33,51.5,16,52,32,20,32,77,156,0,Jay IdzesVenezia
Getafe,Iglesias,1204,es ESP,DF,es La Liga,26,1998,32.1,81,47,42,33,6,46,90,51.1,44,47,8,39,50,131,133,1,IglesiasGetafe
Celta Vigo,Borja Iglesias,1205,es ESP,FW,es La Liga,31,1993,21.7,10,9,2,5,3,4,15,26.7,11,9,2,7,7,17,10,0,Borja IglesiasCelta Vigo
Brighton,Igor,1206,br BRA,DF,eng Premier League,26,1998,10.7,5,5,2,2,1,4,10,40.0,6,24,14,10,4,9,39,1,IgorBrighton
Sevilla,Kelechi Iheanacho,1207,ng NGA,FW,es La Liga,27,1996,4.4,1,0,0,1,0,1,3,33.3,2,0,0,0,0,1,1,0,Kelechi IheanachoSevilla
Como,Jonathan Ikone,1208,fr FRA,FW,it Serie A,26,1998,6.0,15,9,4,3,8,6,11,54.5,5,5,1,4,0,15,1,1,Jonathan IkoneComo
Fiorentina,Jonathan Ikone,1209,fr FRA,"FW,MF",it Serie A,26,1998,3.7,5,2,3,2,0,2,4,50.0,2,3,0,3,1,6,1,0,Jonathan IkoneFiorentina
Monaco,George Ilenikhena,1210,ng NGA,FW,fr Ligue 1,17,2006,8.0,4,2,0,3,1,1,2,50.0,1,0,0,0,2,6,0,0,George IlenikhenaMonaco
Union Berlin,Andrej Ilic,1211,rs SRB,FW,de Bundesliga,24,2000,10.4,2,2,0,2,0,0,6,0.0,6,7,3,4,5,7,6,1,Andrej IlicUnion Berlin
Torino,Ivan Ilic,1212,rs SRB,MF,it Serie A,23,2001,10.2,5,2,0,4,1,2,8,25.0,6,0,0,0,5,10,10,0,Ivan IlicTorino
Nice,Rares Ilie,1213,ro ROU,MF,fr Ligue 1,21,2003,0.1,1,1,1,0,0,1,1,100.0,0,0,0,0,0,1,0,0,Rares IlieNice
Bologna,Samuel Iling-Junior,1214,eng ENG,"FW,MF",it Serie A,20,2003,1.3,3,2,1,1,1,0,1,0.0,1,1,0,1,2,5,2,0,Samuel Iling-JuniorBologna
West Ham,Danny Ings,1215,eng ENG,"FW,MF",eng Premier League,32,1992,3.2,4,2,2,2,0,1,3,33.3,2,5,0,5,1,5,4,0,Danny IngsWest Ham
Como,Alessio Iovine,1216,it ITA,"DF,FW",it Serie A,33,1991,4.3,5,2,2,3,0,4,10,40.0,6,7,1,6,3,8,21,1,Alessio IovineComo
Everton,Tim Iroegbunam,1217,eng ENG,MF,eng Premier League,21,2003,6.4,29,14,14,10,5,14,23,60.9,9,18,4,14,16,45,12,1,Tim IroegbunamEverton
St. Pauli,Jackson Irvine,1218,au AUS,MF,de Bundesliga,31,1993,29.0,56,28,24,26,6,25,45,55.6,20,27,5,22,36,92,63,2,Jackson IrvineSt. Pauli
West Ham,Andy Irving,1219,sct SCO,MF,eng Premier League,24,2000,1.8,7,4,3,3,1,1,5,20.0,4,5,1,4,1,8,5,0,Andy IrvingWest Ham
Newcastle Utd,Alexander Isak,1220,se SWE,FW,eng Premier League,24,1999,30.6,12,5,2,3,7,5,15,33.3,10,18,2,16,3,15,17,1,Alexander IsakNewcastle Utd
Lazio,Gustav Isaksen,1221,dk DEN,FW,it Serie A,23,2001,24.6,16,9,7,8,1,7,28,25.0,21,22,2,20,10,26,21,1,Gustav IsaksenLazio
Betis,Isco,1222,es ESP,MF,es La Liga,32,1992,17.2,20,13,3,13,4,7,28,25.0,21,10,0,10,11,31,7,0,IscoBetis
Lille,Ismaily,1223,br BRA,DF,fr Ligue 1,34,1990,10.0,33,17,17,12,4,17,26,65.4,9,15,1,14,13,46,49,0,IsmailyLille
Empoli,Ardian Ismajli,1224,al ALB,DF,it Serie A,27,1996,27.9,30,23,21,9,0,16,20,80.0,4,35,24,11,56,86,249,3,Ardian IsmajliEmpoli
Montpellier,Yanis Issoufou,1225,fr FRA,"MF,FW",fr Ligue 1,17,2006,0.9,6,4,4,1,1,3,5,60.0,2,1,0,1,0,6,1,0,Yanis IssoufouMontpellier
Gladbach,Ko Itakura,1226,jp JPN,DF,de Bundesliga,27,1997,31.0,40,29,23,16,1,21,34,61.8,13,41,22,19,28,68,171,0,Ko ItakuraGladbach
Bayern Munich,Hiroki Ito,1227,jp JPN,DF,de Bundesliga,25,1999,2.8,2,0,1,1,0,1,1,100.0,0,3,2,1,6,8,15,1,Hiroki ItoBayern Munich
Reims,Junya Ito,1228,jp JPN,"FW,MF",fr Ligue 1,31,1993,29.9,45,30,19,16,10,17,60,28.3,43,33,3,30,13,58,15,2,Junya ItoReims
Sevilla,Diego Iturralde,1229,es ESP,FW,es La Liga,21,2003,0.4,0,0,0,0,0,0,0,,0,0,0,0,1,1,1,0,Diego IturraldeSevilla
Holstein Kiel,Marko Ivezic,1230,rs SRB,DF,de Bundesliga,22,2001,18.4,29,19,20,6,3,15,42,35.7,27,25,13,12,27,56,103,2,Marko IvezicHolstein Kiel
Fulham,Alex Iwobi,1231,ng NGA,"FW,MF",eng Premier League,28,1996,33.1,44,25,14,21,9,22,34,64.7,12,26,1,25,14,58,29,1,Alex IwobiFulham
Monza,Armando Izzo,1232,it ITA,DF,it Serie A,32,1992,27.1,40,15,30,9,1,18,36,50.0,18,38,28,10,45,85,101,0,Armando IzzoMonza
Como,Fellipe Jack,1233,br BRA,DF,it Serie A,18,2006,1.9,9,4,8,1,0,3,5,60.0,2,2,2,0,4,13,5,0,Fellipe JackComo
Chelsea,Nicolas Jackson,1234,sn SEN,FW,eng Premier League,23,2001,24.7,22,13,6,7,9,5,10,50.0,5,15,2,13,3,25,15,0,Nicolas JacksonChelsea
Rennes,Jeremy Jacquet,1235,fr FRA,DF,fr Ligue 1,19,2005,10.3,26,17,11,8,7,14,22,63.6,8,9,3,6,27,53,45,1,Jeremy JacquetRennes
Mainz 05,Lee Jae-sung,1236,kr KOR,MF,de Bundesliga,31,1992,29.4,42,21,16,19,7,15,39,38.5,24,39,3,36,35,77,38,0,Lee Jae-sungMainz 05
Valencia,Ivan Jaime Pajuelo,1237,es ESP,MF,es La Liga,23,2000,3.3,8,5,2,3,3,4,5,80.0,1,2,0,2,2,10,0,0,Ivan Jaime PajueloValencia
Augsburg,Kristijan Jakic,1238,hr CRO,MF,de Bundesliga,27,1997,25.6,46,23,20,19,7,22,43,51.2,21,42,9,33,28,74,50,1,Kristijan JakicAugsburg
Valladolid,Karl Jakob Hein,1239,ee EST,GK,es La Liga,22,2002,31.0,0,0,0,0,0,0,2,0.0,2,0,0,0,0,0,19,2,Karl Jakob HeinValladolid
Monaco,Ismail Jakobs,1240,sn SEN,DF,fr Ligue 1,24,1999,2.0,5,5,3,0,2,3,5,60.0,2,0,0,0,2,7,6,0,Ismail JakobsMonaco
Rennes,Jordan James,1241,wls WAL,MF,fr Ligue 1,20,2004,13.1,30,19,8,18,4,16,30,53.3,14,14,1,13,14,44,17,1,Jordan JamesRennes
Chelsea,Reece James,1242,eng ENG,"DF,MF",eng Premier League,24,1999,11.8,10,9,6,3,1,3,9,33.3,6,14,6,8,13,23,23,4,Reece JamesChelsea
Brentford,Vitaly Janelt,1243,de GER,MF,eng Premier League,26,1998,25.0,38,22,14,13,11,21,36,58.3,15,33,9,24,27,65,53,1,Vitaly JaneltBrentford
Las Palmas,Adnan Januzaj,1244,be BEL,"MF,FW",es La Liga,29,1995,6.6,10,6,1,6,3,5,9,55.6,4,6,0,6,2,12,3,0,Adnan JanuzajLas Palmas
Stuttgart,Luca Jaquez,1245,ch SUI,DF,de Bundesliga,21,2003,2.8,3,0,3,0,0,1,3,33.3,2,2,0,2,3,6,4,0,Luca JaquezStuttgart
Liverpool,Vitezslav Jaros,1246,cz CZE,GK,eng Premier League,23,2001,0.1,0,0,0,0,0,0,0,,0,0,0,0,0,0,0,0,Vitezslav JarosLiverpool
Como,Ali Jasim,1247,iq IRQ,"FW,DF",it Serie A,20,2004,0.1,1,0,1,0,0,1,1,100.0,0,0,0,0,0,1,0,0,Ali JasimComo
Athletic Club,Mikel Jauregizar,1248,es ESP,MF,es La Liga,20,2003,24.9,84,48,25,45,14,41,83,49.4,42,24,4,20,29,113,36,2,Mikel JauregizarAthletic Club
Holstein Kiel,Dominik Javorcek,1249,sk SVK,"DF,MF",de Bundesliga,21,2002,4.3,3,0,3,0,0,1,5,20.0,4,7,3,4,5,8,26,1,Dominik JavorcekHolstein Kiel
Lecce,Gaby Jean,1250,fr FRA,DF,it Serie A,24,2000,15.4,14,7,8,5,1,6,11,54.5,5,13,10,3,9,23,71,1,Gaby JeanLecce
Bournemouth,Daniel Jebbison,1251,ca CAN,FW,eng Premier League,20,2003,1.3,5,3,3,2,0,4,6,66.7,2,2,1,1,1,6,1,0,Daniel JebbisonBournemouth
Stuttgart,Finn Jeltsch,1252,de GER,DF,de Bundesliga,18,2006,8.7,18,13,6,11,1,12,15,80.0,3,12,6,6,13,31,27,2,Finn JeltschStuttgart
Reims,Malcolm Jeng,1253,se SWE,DF,fr Ligue 1,19,2005,1.2,0,0,0,0,0,0,0,,0,1,0,1,3,3,10,0,Malcolm JengReims
Augsburg,Fredrik Jensen,1254,fi FIN,MF,de Bundesliga,26,1997,8.5,7,7,1,3,3,4,5,80.0,1,10,1,9,4,11,17,0,Fredrik JensenAugsburg
Brentford,Mathias Jensen,1255,dk DEN,MF,eng Premier League,28,1996,9.6,14,10,6,6,2,8,16,50.0,8,15,4,11,8,22,13,2,Mathias JensenBrentford
Mainz 05,Moritz Jenz,1256,de GER,DF,de Bundesliga,25,1999,17.8,36,20,18,18,0,16,21,76.2,5,23,14,9,30,66,128,2,Moritz JenzMainz 05
Arsenal,Gabriel Jesus,1257,br BRA,FW,eng Premier League,27,1997,6.8,10,6,4,3,3,4,9,44.4,5,10,1,9,4,14,8,0,Gabriel JesusArsenal
Napoli,Juan Jesus,1258,br BRA,DF,it Serie A,33,1991,11.9,25,14,16,9,0,12,20,60.0,8,15,3,12,9,34,42,0,Juan JesusNapoli
Milan,Alejandro Jimenez,1259,es ESP,"DF,FW",it Serie A,19,2005,14.1,24,13,8,14,2,11,27,40.7,16,24,3,21,15,39,23,0,Alejandro JimenezMilan
Fulham,Raul Jimenez,1260,mx MEX,FW,eng Premier League,33,1991,27.7,35,24,9,17,9,8,22,36.4,14,21,5,16,10,45,23,3,Raul JimenezFulham
Brentford,Kim Jisoo,1261,kr KOR,DF,eng Premier League,19,2004,0.3,0,0,0,0,0,0,0,,0,0,0,0,0,0,2,0,Kim JisooBrentford
Brighton,Joao Pedro,1262,br BRA,"FW,MF",eng Premier League,22,2001,21.6,16,12,6,6,4,4,11,36.4,7,12,0,12,9,25,12,0,Joao PedroBrighton
Getafe,John Joe,1263,ie IRL,"MF,FW",es La Liga,20,2003,0.5,0,0,0,0,0,0,0,,0,1,1,0,0,0,1,0,John JoeGetafe
Reims,John Joe,1264,ie IRL,MF,fr Ligue 1,20,2003,6.1,24,15,11,10,3,7,19,36.8,12,11,2,9,6,30,9,0,John JoeReims
Newcastle Utd,Joelinton,1265,br BRA,"MF,FW",eng Premier League,27,1996,26.6,57,35,23,23,11,25,44,56.8,19,37,7,30,23,80,47,2,JoelintonNewcastle Utd
Espanyol,Jofre,1266,es ESP,"MF,FW",es La Liga,23,2001,24.1,22,16,14,5,3,13,23,56.5,10,13,0,13,15,37,29,0,JofreEspanyol
Lecce,Thorir Johann Helgason,1267,is ISL,MF,it Serie A,23,2000,12.8,10,7,3,6,1,7,13,53.8,6,7,2,5,6,16,11,2,Thorir Johann HelgasonLecce
Holstein Kiel,Carl Johansson,1268,se SWE,DF,de Bundesliga,30,1994,6.3,4,2,4,0,0,3,7,42.9,4,12,8,4,10,14,54,1,Carl JohanssonHolstein Kiel
Ipswich Town,Ben Johnson,1269,eng ENG,"DF,FW",eng Premier League,24,2000,15.0,38,22,23,12,3,20,41,48.8,21,22,5,17,13,51,54,1,Ben JohnsonIpswich Town
Tottenham,Brennan Johnson,1270,wls WAL,FW,eng Premier League,23,2001,24.2,39,26,9,20,10,16,34,47.1,18,25,3,22,4,43,14,0,Brennan JohnsonTottenham
Strasbourg,Karl-Johan Johnsson,1271,se SWE,GK,fr Ligue 1,34,1990,3.0,0,0,0,0,0,0,1,0.0,1,0,0,0,0,0,3,0,Karl-Johan JohnssonStrasbourg
Wolves,Sam Johnstone,1272,eng ENG,GK,eng Premier League,31,1993,7.0,0,0,0,0,0,0,1,0.0,1,0,0,0,0,0,7,0,Sam JohnstoneWolves
Auxerre,Paul Joly,1273,fr FRA,DF,fr Ligue 1,24,2000,11.2,49,32,30,17,2,27,45,60.0,18,19,1,18,25,74,32,5,Paul JolyAuxerre
Liverpool,Curtis Jones,1274,eng ENG,"MF,DF",eng Premier League,23,2001,19.0,39,22,6,23,10,17,27,63.0,10,22,9,13,7,46,10,3,Curtis JonesLiverpool
Barcelona,Frenkie de Jong,1275,nl NED,MF,es La Liga,27,1997,12.7,19,11,5,8,6,8,16,50.0,8,9,1,8,12,31,7,1,Frenkie de JongBarcelona
Alaves,Joan Jordan,1276,es ESP,MF,es La Liga,30,1994,15.7,32,18,11,17,4,17,30,56.7,13,12,0,12,9,41,21,0,Joan JordanAlaves
Arsenal,Jorginho,1277,it ITA,MF,eng Premier League,32,1991,7.8,12,4,1,7,4,8,20,40.0,12,3,0,3,7,19,2,2,JorginhoArsenal
Venezia,Jesse Joronen,1278,fi FIN,GK,it Serie A,31,1993,7.8,0,0,0,0,0,0,0,,0,0,0,0,0,0,4,1,Jesse JoronenVenezia
Rennes,Jota,1279,pt POR,"FW,MF",fr Ligue 1,25,1999,3.7,5,2,2,3,0,4,7,57.1,3,1,0,1,3,8,2,0,JotaRennes
Liverpool,Diogo Jota,1280,pt POR,FW,eng Premier League,27,1996,13.3,14,8,2,8,4,7,19,36.8,12,9,0,9,8,22,6,0,Diogo JotaLiverpool
Le Havre,Antoine Joujou,1281,fr FRA,"MF,FW",fr Ligue 1,21,2003,10.5,16,11,10,4,2,9,15,60.0,6,15,3,12,9,25,19,0,Antoine JoujouLe Havre
Milan,Luka Jovic,1282,rs SRB,"FW,MF",it Serie A,26,1997,6.2,0,0,0,0,0,0,0,,0,2,1,1,1,1,3,0,Luka JovicMilan
Getafe,Juanmi,1283,es ESP,"FW,MF",es La Liga,31,1993,7.7,14,11,4,7,3,6,19,31.6,13,6,0,6,2,16,3,0,JuanmiGetafe
Betis,Juanmi,1284,es ESP,"FW,MF",es La Liga,31,1993,2.7,7,4,3,3,1,4,6,66.7,2,4,0,4,1,8,4,0,JuanmiBetis
Girona,Juanpe,1285,es ESP,DF,es La Liga,33,1991,8.1,8,5,5,3,0,6,8,75.0,2,15,10,5,8,16,56,1,JuanpeGirona
Auxerre,Jubal,1286,br BRA,DF,fr Ligue 1,30,1993,29.3,60,39,46,13,1,28,40,70.0,12,61,36,25,25,85,201,1,JubalAuxerre
Werder Bremen,Anthony Jung,1287,de GER,DF,de Bundesliga,32,1991,21.1,34,22,22,11,1,22,34,64.7,12,23,14,9,25,59,77,1,Anthony JungWerder Bremen
Villarreal,Luiz Lucio Reis Junior,1288,br BRA,GK,es La Liga,23,2001,16.2,0,0,0,0,0,0,0,,0,0,0,0,0,0,14,1,Luiz Lucio Reis JuniorVillarreal
Auxerre,Hamed Junior Traore,1289,ci CIV,MF,fr Ligue 1,24,2000,23.3,41,20,11,17,13,16,54,29.6,38,14,0,14,8,49,11,0,Hamed Junior TraoreAuxerre
Real Madrid,Vinicius Junior,1290,br BRA,FW,es La Liga,24,2000,25.0,21,10,7,4,10,5,18,27.8,13,9,0,9,3,24,1,2,Vinicius JuniorReal Madrid
Union Berlin,Josip Juranovic,1291,hr CRO,"DF,MF",de Bundesliga,28,1995,12.9,21,13,12,6,3,10,25,40.0,15,13,6,7,7,28,42,2,Josip JuranovicUnion Berlin
Hoffenheim,David Jurasek,1292,cz CZE,DF,de Bundesliga,23,2000,6.9,6,3,3,2,1,2,5,40.0,3,5,0,5,6,12,17,0,David JurasekHoffenheim
Valladolid,Stanko Juric,1293,hr CRO,MF,es La Liga,27,1996,19.2,48,24,26,19,3,19,48,39.6,29,35,11,24,24,72,52,0,Stanko JuricValladolid
Leicester City,James Justin,1294,eng ENG,DF,eng Premier League,26,1998,32.4,58,37,29,23,6,32,55,58.2,23,48,17,31,46,104,141,3,James JustinLeicester City
Chelsea,Filip Jorgensen,1295,dk DEN,GK,eng Premier League,22,2002,6.0,0,0,0,0,0,0,0,,0,0,0,0,0,0,0,3,Filip JorgensenChelsea
Lecce,Mohamed Kaba,1296,fr FRA,MF,it Serie A,22,2001,5.0,13,8,7,5,1,8,10,80.0,2,11,4,7,4,17,10,1,Mohamed KabaLecce
Augsburg,Yusuf Kabadayi,1297,de GER,"FW,MF",de Bundesliga,20,2004,0.8,1,0,0,1,0,0,0,,0,1,0,1,0,1,0,0,Yusuf KabadayiAugsburg
Dortmund,Almugera Kabar,1298,de GER,DF,de Bundesliga,18,2006,1.5,5,3,2,2,1,3,3,100.0,0,1,0,1,1,6,4,0,Almugera KabarDortmund
Udinese,Christian Kabasele,1299,be BEL,DF,it Serie A,33,1991,12.9,17,9,10,7,0,11,14,78.6,3,14,8,6,14,31,75,1,Christian KabaseleUdinese
Werder Bremen,Issa Kabore,1300,bf BFA,"DF,FW",de Bundesliga,23,2001,3.4,8,4,2,5,1,4,6,66.7,2,8,2,6,2,10,7,0,Issa KaboreWerder Bremen
Reims,Yaya Kader Fofana,1301,ml MLI,"MF,FW",fr Ligue 1,20,2004,7.0,17,11,8,5,4,4,12,33.3,8,11,2,9,3,20,2,0,Yaya Kader FofanaReims
Hoffenheim,Pavel Kaderabek,1302,cz CZE,DF,de Bundesliga,32,1992,17.5,25,14,14,4,7,15,31,48.4,16,13,3,10,20,45,54,1,Pavel KaderabekHoffenheim
Nantes,Tino Kadewere,1303,zw ZIM,"MF,FW",fr Ligue 1,28,1996,5.7,14,8,5,3,6,6,13,46.2,7,3,0,3,6,20,8,0,Tino KadewereNantes
Brighton,Ferdi Kadioglu,1304,tr TUR,"DF,MF",eng Premier League,24,1999,4.3,10,6,4,5,1,6,15,40.0,9,2,2,0,8,18,17,0,Ferdi KadiogluBrighton
Rennes,Arnaud Kalimuendo,1305,fr FRA,"FW,MF",fr Ligue 1,22,2002,28.6,19,12,6,9,4,7,15,46.7,8,9,2,7,4,23,16,1,Arnaud KalimuendoRennes
Juventus,Pierre Kalulu,1306,fr FRA,DF,it Serie A,24,2000,26.0,41,25,29,9,3,18,24,75.0,6,27,15,12,17,58,68,1,Pierre KaluluJuventus
Angers,Justin-Noel Kalumba,1307,fr FRA,"FW,MF",fr Ligue 1,19,2004,0.3,0,0,0,0,0,0,0,,0,0,0,0,1,1,1,0,Justin-Noel KalumbaAngers
Crystal Palace,Daichi Kamada,1308,jp JPN,MF,eng Premier League,27,1996,17.4,47,29,19,24,4,14,41,34.1,27,22,5,17,18,65,14,0,Daichi KamadaCrystal Palace
Toulouse,Warren Kamanzi,1309,no NOR,"DF,MF",fr Ligue 1,23,2000,11.4,29,13,12,12,5,14,28,50.0,14,7,3,4,9,38,25,0,Warren KamanziToulouse
Aston Villa,Boubacar Kamara,1310,fr FRA,MF,eng Premier League,24,1999,19.2,50,21,28,18,4,29,56,51.8,27,19,7,12,19,69,51,3,Boubacar KamaraAston Villa
Rennes,Glen Kamara,1311,fi FIN,MF,fr Ligue 1,28,1995,7.4,23,11,10,11,2,11,17,64.7,6,7,0,7,7,30,7,0,Glen KamaraRennes
Udinese,Hassane Kamara,1312,ci CIV,DF,it Serie A,30,1994,22.2,35,25,20,11,4,16,28,57.1,12,23,5,18,26,61,49,1,Hassane KamaraUdinese
Paris S-G,Noham Kamara,1313,fr FRA,DF,fr Ligue 1,17,2007,0.8,1,1,0,1,0,0,0,,0,1,1,0,1,2,1,0,Noham KamaraParis S-G
Villarreal,Willy Kambwala,1314,fr FRA,DF,es La Liga,19,2004,12.4,17,12,14,2,1,10,12,83.3,2,10,7,3,10,27,56,1,Willy KambwalaVillarreal
Wolfsburg,Jakub Kaminski,1315,pl POL,"DF,MF",de Bundesliga,22,2002,12.6,17,8,8,3,6,9,22,40.9,13,17,7,10,13,30,23,1,Jakub KaminskiWolfsburg
RB Leipzig,Kevin Kampl,1316,si SVN,MF,de Bundesliga,33,1990,17.7,27,18,11,10,6,16,26,61.5,10,25,6,19,24,51,25,0,Kevin KamplRB Leipzig
Strasbourg,Nordine Kandil,1317,fr FRA,MF,fr Ligue 1,22,2001,0.1,0,0,0,0,0,0,0,,0,0,0,0,0,0,1,0,Nordine KandilStrasbourg
Bayern Munich,Harry Kane,1318,eng ENG,FW,de Bundesliga,31,1993,26.5,13,11,3,8,2,2,6,33.3,4,16,2,14,2,15,16,0,Harry KaneBayern Munich
Paris S-G,Lee Kang-in,1319,kr KOR,"FW,MF",fr Ligue 1,23,2001,18.5,25,17,7,11,7,19,35,54.3,16,11,1,10,3,28,3,1,Lee Kang-inParis S-G
Torino,Yann Karamoh,1320,fr FRA,"MF,FW",it Serie A,26,1998,11.6,5,2,2,1,2,4,9,44.4,5,10,2,8,3,8,5,0,Yann KaramohTorino
Stuttgart,Atakan Karazor,1321,,MF,de Bundesliga,27,1996,29.1,59,29,19,28,12,29,57,50.9,28,39,7,32,32,91,51,1,Atakan KarazorStuttgart
Bologna,Jesper Karlsson,1322,se SWE,FW,it Serie A,26,1998,3.3,1,0,0,0,1,0,2,0.0,2,4,0,4,0,1,3,0,Jesper KarlssonBologna
Lecce,Jesper Karlsson,1323,se SWE,FW,it Serie A,26,1998,5.5,3,2,3,0,0,2,8,25.0,6,2,0,2,0,3,4,0,Jesper KarlssonLecce
Udinese,Jesper Karlstrom,1324,se SWE,MF,it Serie A,29,1995,35.4,61,34,32,21,8,25,51,49.0,26,28,11,17,35,96,82,5,Jesper KarlstromUdinese
Genoa,Lior Kasa,1325,il ISR,"MF,FW",it Serie A,18,2005,2.6,4,4,2,2,0,2,5,40.0,3,4,1,3,3,7,5,0,Lior KasaGenoa
Hellas Verona,Grigoris Kastanos,1326,cy CYP,"MF,FW",it Serie A,26,1998,9.7,23,16,8,7,8,9,21,42.9,12,17,2,15,7,30,8,0,Grigoris KastanosHellas Verona
Heidenheim,Mikkel Kaufmann,1327,dk DEN,FW,de Bundesliga,23,2001,4.1,6,4,1,3,2,2,5,40.0,3,5,2,3,2,8,7,0,Mikkel KaufmannHeidenheim
Southampton,Joachim Kayi Sanda,1328,fr FRA,DF,eng Premier League,17,2006,0.2,0,0,0,0,0,0,0,,0,0,0,0,2,2,0,0,Joachim Kayi SandaSouthampton
Brentford,Michael Kayode,1329,it ITA,DF,eng Premier League,20,2004,5.9,17,11,12,5,0,9,13,69.2,4,3,0,3,7,24,19,0,Michael KayodeBrentford
Fiorentina,Michael Kayode,1330,it ITA,"DF,FW",it Serie A,20,2004,1.4,1,1,1,0,0,0,0,,0,3,1,2,2,3,7,0,Michael KayodeFiorentina
Fiorentina,Moise Kean,1331,it ITA,FW,it Serie A,24,2000,29.1,7,5,1,2,4,3,4,75.0,1,12,0,12,5,12,26,1,Moise KeanFiorentina
Everton,Michael Keane,1332,eng ENG,DF,eng Premier League,31,1993,11.7,12,9,8,2,2,8,15,53.3,7,14,10,4,16,28,65,2,Michael KeaneEverton
Le Havre,Yassine Kechta,1333,ma MAR,"MF,FW",fr Ligue 1,22,2002,23.3,60,36,32,21,7,33,78,42.3,45,25,2,23,26,86,32,2,Yassine KechtaLe Havre
Monaco,Thilo Kehrer,1334,de GER,DF,fr Ligue 1,27,1996,26.5,37,23,26,11,0,22,38,57.9,16,18,10,8,36,73,113,1,Thilo KehrerMonaco
Getafe,Abdoulaye Keita,1335,es ESP,"FW,MF",es La Liga,21,2002,1.1,2,2,0,1,1,2,4,50.0,2,1,0,1,0,2,3,0,Abdoulaye KeitaGetafe
Parma,Mandela Keita,1336,be BEL,MF,it Serie A,22,2002,20.3,44,25,13,25,6,18,35,51.4,17,18,7,11,21,65,29,2,Mandela KeitaParma
Stuttgart,Yannik Keitel,1337,de GER,MF,de Bundesliga,24,2000,3.0,9,6,3,5,1,9,10,90.0,1,5,2,3,4,13,6,0,Yannik KeitelStuttgart
Holstein Kiel,Andu Kelati,1338,de GER,"MF,DF",de Bundesliga,21,2002,3.2,7,4,2,4,1,2,5,40.0,3,4,1,3,3,10,3,0,Andu KelatiHolstein Kiel
Liverpool,Caoimhin Kelleher,1339,ie IRL,GK,eng Premier League,25,1998,10.0,0,0,0,0,0,0,0,,0,0,0,0,0,0,1,2,Caoimhin KelleherLiverpool
Heidenheim,Thomas Keller,1340,de GER,"DF,MF",de Bundesliga,24,1999,1.6,6,5,5,1,0,4,6,66.7,2,3,1,2,4,10,11,0,Thomas KellerHeidenheim
Newcastle Utd,Lloyd Kelly,1341,eng ENG,DF,eng Premier League,25,1998,3.4,5,4,4,1,0,1,1,100.0,0,6,4,2,1,6,17,0,Lloyd KellyNewcastle Utd
Juventus,Lloyd Kelly,1342,eng ENG,DF,it Serie A,25,1998,11.3,15,11,5,9,1,7,9,77.8,2,11,6,5,2,17,56,3,Lloyd KellyJuventus
Union Berlin,Aljoscha Kemlein,1343,de GER,MF,de Bundesliga,19,2004,10.2,10,4,4,5,1,5,14,35.7,9,14,3,11,6,16,15,0,Aljoscha KemleinUnion Berlin
Como,Marc-Oliver Kempf,1344,de GER,DF,it Serie A,29,1995,29.1,30,20,15,14,1,13,24,54.2,11,35,26,9,33,63,136,4,Marc-Oliver KempfComo
Valladolid,Kenedy,1345,br BRA,"MF,FW",es La Liga,28,1996,0.1,0,0,0,0,0,0,0,,0,1,0,1,0,0,0,0,KenedyValladolid
Heidenheim,Luca Kerber,1346,de GER,"MF,DF",de Bundesliga,22,2002,8.7,26,16,17,8,1,16,31,51.6,15,14,4,10,5,31,25,1,Luca KerberHeidenheim
Bournemouth,Milos Kerkez,1347,hu HUN,DF,eng Premier League,20,2003,37.1,52,26,25,20,7,24,38,63.2,14,38,11,27,45,97,106,4,Milos KerkezBournemouth
Reims,Reda Khadra,1348,de GER,"MF,FW",fr Ligue 1,23,2001,0.9,1,1,1,0,0,0,1,0.0,1,0,0,0,0,1,1,0,Reda KhadraReims
Leicester City,Bilal El Khannouss,1349,ma MAR,"MF,FW",eng Premier League,20,2004,24.2,50,30,16,29,5,17,32,53.1,15,22,4,18,6,56,10,3,Bilal El KhannoussLeicester City
Montpellier,Wahbi Khazri,1350,tn TUN,"FW,MF",fr Ligue 1,33,1991,12.4,25,18,5,16,4,8,21,38.1,13,13,1,12,5,30,7,0,Wahbi KhazriMontpellier
Union Berlin,Rani Khedira,1351,de GER,MF,de Bundesliga,30,1994,30.3,68,40,30,35,3,24,38,63.2,14,33,11,22,44,112,55,0,Rani KhediraUnion Berlin
Manchester City,Abdukodir Khusanov,1352,uz UZB,DF,eng Premier League,20,2004,5.6,5,4,4,1,0,2,3,66.7,1,5,4,1,3,8,29,1,Abdukodir KhusanovManchester City
Lens,Abdukodir Khusanov,1353,uz UZB,DF,fr Ligue 1,20,2004,10.8,15,11,9,5,1,7,11,63.6,4,17,11,6,26,41,57,0,Abdukodir KhusanovLens
Lecce,Kialonda,1354,ao ANG,DF,it Serie A,26,1997,23.8,34,12,24,10,0,12,17,70.6,5,44,28,16,32,66,132,1,KialondaLecce
Alaves,Kike,1355,es ESP,FW,es La Liga,34,1989,28.2,19,14,1,12,6,6,17,35.3,11,11,4,7,1,20,23,0,KikeAlaves
West Ham,Max Kilman,1356,eng ENG,DF,eng Premier League,27,1997,37.2,39,24,16,20,3,23,27,85.2,4,58,40,18,38,77,212,6,Max KilmanWest Ham
Bayern Munich,Joshua Kimmich,1357,de GER,MF,de Bundesliga,29,1995,31.6,47,29,11,29,7,30,50,60.0,20,23,3,20,25,72,34,3,Joshua KimmichBayern Munich
Paris S-G,Presnel Kimpembe,1358,fr FRA,DF,fr Ligue 1,28,1995,0.3,1,0,1,0,0,0,0,,0,2,2,0,0,1,1,0,Presnel KimpembeParis S-G
Fulham,Joshua King,1359,eng ENG,MF,eng Premier League,17,2007,1.4,7,5,3,4,0,0,3,0.0,3,3,0,3,1,8,1,0,Joshua KingFulham
Toulouse,Joshua King,1360,no NOR,"FW,MF",fr Ligue 1,32,1992,18.6,11,11,4,4,3,5,12,41.7,7,10,3,7,6,17,19,0,Joshua KingToulouse
Wolves,Tom King,1361,wls WAL,GK,eng Premier League,29,1995,0.0,0,0,0,0,0,0,0,,0,0,0,0,0,0,0,0,Tom KingWolves
Tottenham,Antonin Kinsky,1362,cz CZE,GK,eng Premier League,21,2003,6.0,3,1,3,0,0,1,1,100.0,0,0,0,0,0,3,9,1,Antonin KinskyTottenham
Reims,Cedric Kipre,1363,ci CIV,DF,fr Ligue 1,27,1996,24.3,42,30,30,11,1,29,39,74.4,10,42,27,15,32,74,162,2,Cedric KipreReims
Arsenal,Jakub Kiwior,1364,pl POL,DF,eng Premier League,24,2000,12.5,22,8,13,7,2,11,15,73.3,4,13,8,5,6,28,58,3,Jakub KiwiorArsenal
Gladbach,Tim Kleindienst,1365,de GER,FW,de Bundesliga,28,1995,30.4,30,15,6,15,9,10,35,28.6,25,45,9,36,12,42,66,1,Tim KleindienstGladbach
RB Leipzig,Lukas Klostermann,1366,de GER,DF,de Bundesliga,28,1996,20.4,27,14,18,7,2,14,24,58.3,10,31,17,14,24,51,143,3,Lukas KlostermannRB Leipzig
Bournemouth,Justin Kluivert,1367,nl NED,MF,eng Premier League,25,1999,26.0,23,11,4,11,8,4,22,18.2,18,24,0,24,14,37,24,1,Justin KluivertBournemouth
Eint Frankfurt,Ansgar Knauff,1368,de GER,"MF,DF",de Bundesliga,22,2002,17.7,41,22,18,16,7,12,26,46.2,14,23,4,19,12,53,24,0,Ansgar KnauffEint Frankfurt
Holstein Kiel,Magnus Knudsen,1369,no NOR,MF,de Bundesliga,23,2001,20.6,48,29,21,21,6,25,44,56.8,19,18,4,14,12,60,44,0,Magnus KnudsenHolstein Kiel
Dortmund,Gregor Kobel,1370,ch SUI,GK,de Bundesliga,26,1997,32.0,0,0,0,0,0,0,0,,0,0,0,0,1,1,23,3,Gregor KobelDortmund
Eint Frankfurt,Robin Koch,1371,de GER,DF,de Bundesliga,28,1996,28.7,24,11,14,8,2,10,22,45.5,12,39,25,14,25,49,197,4,Robin KochEint Frankfurt
Lens,Herve Koffi,1372,bf BFA,GK,fr Ligue 1,27,1996,5.0,1,1,1,0,0,1,1,100.0,0,0,0,0,0,1,5,0,Herve KoffiLens
Venezia,Magnus Kofod Andersen,1373,dk DEN,MF,it Serie A,25,1999,7.7,13,4,3,9,1,4,10,40.0,6,7,2,5,6,19,12,0,Magnus Kofod AndersenVenezia
Werder Bremen,Derrick Kohn,1374,de GER,"DF,FW",de Bundesliga,25,1999,14.9,20,10,7,10,3,10,14,71.4,4,21,4,17,10,30,26,0,Derrick KohnWerder Bremen
Monaco,Philipp Kohn,1375,ch SUI,GK,fr Ligue 1,26,1998,19.0,0,0,0,0,0,0,1,0.0,1,0,0,0,0,0,11,2,Philipp KohnMonaco
Mainz 05,Dominik Kohr,1376,de GER,"DF,MF",de Bundesliga,30,1994,25.5,62,46,34,21,7,35,55,63.6,20,43,24,19,42,104,127,0,Dominik KohrMainz 05
Le Havre,Koka,1377,eg EGY,FW,fr Ligue 1,31,1993,9.5,4,1,1,3,0,0,4,0.0,4,3,0,3,4,8,6,1,KokaLe Havre
Atletico Madrid,Koke,1378,es ESP,MF,es La Liga,32,1992,21.4,46,23,18,22,6,21,43,48.8,22,24,2,22,20,66,29,2,KokeAtletico Madrid
Atalanta,Sead Kolasinac,1379,ba BIH,DF,it Serie A,31,1993,21.1,41,26,21,20,0,16,30,53.3,14,16,7,9,25,66,53,1,Sead KolasinacAtalanta
Juventus,Randal Kolo Muani,1380,fr FRA,FW,it Serie A,25,1998,12.9,11,7,3,5,3,4,5,80.0,1,8,0,8,4,15,2,0,Randal Kolo MuaniJuventus
Paris S-G,Randal Kolo Muani,1381,fr FRA,FW,fr Ligue 1,25,1998,4.0,4,4,1,1,2,0,2,0.0,2,1,0,1,0,4,5,0,Randal Kolo MuaniParis S-G
Holstein Kiel,Marco Komenda,1382,hr CRO,DF,de Bundesliga,27,1996,14.5,26,17,12,13,1,11,15,73.3,4,23,11,12,6,32,68,0,Marco KomendaHolstein Kiel
Augsburg,Mert Komur,1383,de GER,MF,de Bundesliga,19,2005,7.3,3,2,2,0,1,0,3,0.0,3,9,3,6,3,6,7,1,Mert KomurAugsburg
Liverpool,Ibrahima Konate,1384,fr FRA,DF,eng Premier League,25,1999,28.4,40,26,25,13,2,25,35,71.4,10,29,15,14,17,57,133,3,Ibrahima KonateLiverpool
Empoli,Ismael Konate,1385,ci CIV,"FW,MF",it Serie A,18,2006,1.3,4,2,4,0,0,2,3,66.7,1,3,2,1,0,4,1,0,Ismael KonateEmpoli
Marseille,Geoffrey Kondogbia,1386,cf CTA,"DF,MF",fr Ligue 1,31,1993,22.4,60,38,31,26,3,27,34,79.4,7,23,6,17,22,82,64,4,Geoffrey KondogbiaMarseille
Reims,Abdoul Kone,1387,fr FRA,DF,fr Ligue 1,19,2005,1.5,5,3,4,1,0,3,5,60.0,2,2,1,1,1,6,5,0,Abdoul KoneReims
Reims,Amadou Kone,1388,ml MLI,MF,fr Ligue 1,19,2005,14.4,49,32,32,16,1,22,35,62.9,13,18,4,14,19,68,38,2,Amadou KoneReims
Marseille,Ismael Kone,1389,ca CAN,"MF,FW",fr Ligue 1,22,2002,4.0,8,4,3,3,2,3,4,75.0,1,4,1,3,4,12,2,1,Ismael KoneMarseille
Rennes,Ismael Kone,1390,ca CAN,MF,fr Ligue 1,22,2002,5.2,9,6,4,4,1,5,7,71.4,2,9,2,7,4,13,5,0,Ismael KoneRennes
Roma,Manu Kone,1391,fr FRA,MF,it Serie A,23,2001,28.6,41,26,17,17,7,19,40,47.5,21,27,4,23,24,65,28,0,Manu KoneRoma
Aston Villa,Ezri Konsa,1392,eng ENG,DF,eng Premier League,26,1997,32.6,34,18,20,10,4,20,25,80.0,5,20,11,9,24,58,114,4,Ezri KonsaAston Villa
Juventus,Teun Koopmeiners,1393,nl NED,"MF,FW",it Serie A,26,1998,22.2,32,16,6,19,7,10,30,33.3,20,36,14,22,8,40,26,2,Teun KoopmeinersJuventus
Bochum,Kacper Koscierski,1394,de GER,DF,de Bundesliga,17,2007,0.1,0,0,0,0,0,0,0,,0,0,0,0,0,0,0,0,Kacper KoscierskiBochum
Atalanta,Odilon Kossounou,1395,ci CIV,DF,it Serie A,23,2001,12.5,16,11,8,6,2,6,13,46.2,7,16,6,10,13,29,25,1,Odilon KossounouAtalanta
Fiorentina,Christian Kouame,1396,ci CIV,"FW,MF",it Serie A,26,1997,6.9,13,8,4,4,5,0,3,0.0,3,3,1,2,2,15,10,0,Christian KouameFiorentina
Empoli,Christian Kouame,1397,ci CIV,"FW,MF",it Serie A,26,1997,5.6,5,4,0,3,2,2,4,50.0,2,4,2,2,0,5,4,0,Christian KouameEmpoli
Augsburg,Henri Koudossou,1398,de GER,DF,de Bundesliga,24,1999,8.3,18,10,6,11,1,11,19,57.9,8,8,2,6,15,33,37,0,Henri KoudossouAugsburg
Wolfsburg,Konstantinos Koulierakis,1399,gr GRE,DF,de Bundesliga,20,2003,27.4,40,20,25,13,2,25,40,62.5,15,34,14,20,33,73,147,2,Konstantinos KoulierakisWolfsburg
Marseille,Emmanuel Koum Mbondo,1400,fr FRA,DF,fr Ligue 1,18,2006,0.1,0,0,0,0,0,0,0,,0,0,0,0,0,0,0,0,Emmanuel Koum MbondoMarseille
Barcelona,Jules Kounde,1401,fr FRA,DF,es La Liga,25,1998,28.9,63,43,29,23,11,44,66,66.7,22,35,5,30,20,83,68,2,Jules KoundeBarcelona
Montpellier,Boubakar Kouyate,1402,ml MLI,DF,fr Ligue 1,27,1997,8.4,22,17,16,6,0,11,19,57.9,8,17,11,6,12,34,54,0,Boubakar KouyateMontpellier
Manchester City,Mateo Kovacic,1403,hr CRO,MF,eng Premier League,30,1994,24.4,69,38,23,38,8,31,65,47.7,34,20,0,20,24,93,21,1,Mateo KovacicManchester City
Empoli,Viktor Kovalenko,1404,ua UKR,MF,it Serie A,28,1996,0.9,2,1,0,2,0,0,1,0.0,1,0,0,0,0,2,0,0,Viktor KovalenkoEmpoli
Leverkusen,Matej Kovar,1405,cz CZE,GK,de Bundesliga,24,2000,5.0,0,0,0,0,0,0,0,,0,0,0,0,0,0,0,1,Matej KovarLeverkusen
Parma,Mateusz Kowalski,1406,pl POL,MF,it Serie A,19,2005,0.6,0,0,0,0,0,0,0,,0,1,0,1,0,0,1,0,Mateusz KowalskiParma
Lens,Goduine Koyalipou,1407,cf CTA,FW,fr Ligue 1,24,2000,9.8,3,2,0,3,0,1,1,100.0,0,4,0,4,1,4,8,0,Goduine KoyalipouLens
Crystal Palace,Caleb Kporha,1408,eng ENG,DF,eng Premier League,18,2006,0.1,2,1,2,0,0,2,2,100.0,0,0,0,0,0,2,1,0,Caleb KporhaCrystal Palace
Newcastle Utd,Emil Krafth,1409,se SWE,DF,eng Premier League,29,1994,3.8,4,2,2,1,1,2,3,66.7,1,5,4,1,2,6,16,0,Emil KrafthNewcastle Utd
Espanyol,Alex Kral,1410,cz CZE,MF,es La Liga,26,1998,30.2,55,37,28,24,3,16,30,53.3,14,34,14,20,28,83,51,2,Alex KralEspanyol
Hoffenheim,Andrej Kramaric,1411,hr CRO,"MF,FW",de Bundesliga,33,1991,30.7,15,8,5,8,2,6,11,54.5,5,16,3,13,7,22,11,1,Andrej KramaricHoffenheim
Heidenheim,Frans Kratzig,1412,de GER,"DF,MF",de Bundesliga,21,2003,13.5,32,18,14,12,6,12,21,57.1,9,12,1,11,17,49,15,0,Frans KratzigHeidenheim
Stuttgart,Frans Kratzig,1413,de GER,DF,de Bundesliga,21,2003,0.6,2,1,1,0,1,1,3,33.3,2,2,1,1,0,2,1,0,Frans KratzigStuttgart
Bochum,Tom Krauss,1414,de GER,MF,de Bundesliga,23,2001,12.0,35,18,20,13,2,19,38,50.0,19,26,2,24,11,46,19,1,Tom KraussBochum
Girona,Ladislav Krejci,1415,cz CZE,DF,es La Liga,25,1999,27.1,23,16,19,4,0,14,26,53.8,12,24,19,5,34,57,93,5,Ladislav KrejciGirona
Eint Frankfurt,Rasmus Kristensen,1416,dk DEN,DF,de Bundesliga,27,1997,27.9,59,33,37,17,5,40,67,59.7,27,50,13,37,20,79,97,1,Rasmus KristensenEint Frankfurt
Udinese,Thomas Kristensen,1417,dk DEN,DF,it Serie A,22,2002,19.5,31,21,16,11,4,20,32,62.5,12,18,13,5,21,52,80,2,Thomas KristensenUdinese
Lecce,Nikola Krstovic,1418,me MNE,FW,it Serie A,24,2000,34.0,18,9,4,7,7,7,16,43.8,9,12,7,5,7,25,24,0,Nikola KrstovicLecce
Freiburg,Lukas Kubler,1419,de GER,DF,de Bundesliga,31,1992,20.5,40,21,17,20,3,27,48,56.3,21,32,13,19,53,93,61,3,Lukas KublerFreiburg
Real Sociedad,Takefusa Kubo,1420,jp JPN,"MF,FW",es La Liga,23,2001,26.4,31,20,11,11,9,16,40,40.0,24,38,1,37,17,48,13,1,Takefusa KuboReal Sociedad
West Ham,Mohammed Kudus,1421,gh GHA,"FW,MF",eng Premier League,23,2000,28.8,38,23,9,18,11,10,27,37.0,17,24,1,23,4,42,8,2,Mohammed KudusWest Ham
Tottenham,Dejan Kulusevski,1422,se SWE,"MF,FW",eng Premier League,24,2000,26.5,45,23,17,13,15,19,51,37.3,32,34,5,29,13,58,10,1,Dejan KulusevskiTottenham
Lyon,Sael Kumbedi,1423,fr FRA,DF,fr Ligue 1,19,2005,10.6,28,14,11,13,4,14,20,70.0,6,11,3,8,8,36,32,1,Sael KumbediLyon
Espanyol,Marash Kumbulla,1424,al ALB,DF,es La Liga,24,2000,33.0,51,26,35,14,2,24,41,58.5,17,48,35,13,34,85,224,2,Marash KumbullaEspanyol
Bayern Munich,Jonah Kusi-Asare,1425,se SWE,FW,de Bundesliga,17,2007,0.0,1,0,0,0,1,0,0,,0,0,0,0,0,1,0,0,Jonah Kusi-AsareBayern Munich
Le Havre,Daler Kuzyaev,1426,ru RUS,MF,fr Ligue 1,31,1993,6.3,13,8,7,4,2,2,9,22.2,7,7,4,3,9,22,8,0,Daler KuzyaevLe Havre
Napoli,Khvicha Kvaratskhelia,1427,ge GEO,"FW,MF",it Serie A,23,2001,13.1,15,9,4,10,1,4,15,26.7,11,13,0,13,4,19,7,0,Khvicha KvaratskheliaNapoli
Paris S-G,Khvicha Kvaratskhelia,1428,ge GEO,FW,fr Ligue 1,23,2001,10.2,19,13,4,12,3,13,23,56.5,10,7,0,7,2,21,4,0,Khvicha KvaratskheliaParis S-G
Bochum,Moritz-Broni Kwarteng,1429,gh GHA,"MF,FW",de Bundesliga,26,1998,1.9,4,3,1,1,2,1,2,50.0,1,0,0,0,0,4,1,0,Moritz-Broni KwartengBochum
Monza,Giorgos Kyriakopoulos,1430,gr GRE,DF,it Serie A,28,1996,31.6,43,26,20,18,5,30,61,49.2,31,28,10,18,23,66,79,0,Giorgos KyriakopoulosMonza
Celta Vigo,Luca de la Torre,1431,us USA,MF,es La Liga,26,1998,0.0,0,0,0,0,0,0,0,,0,0,0,0,0,0,0,0,Luca de la TorreCelta Vigo
Lens,Remy Labeau Lascary,1432,gp GLP,"FW,MF",fr Ligue 1,21,2003,7.1,16,10,7,6,3,5,11,45.5,6,5,0,5,1,17,7,0,Remy Labeau LascaryLens
Nice,Gaetan Laborde,1433,fr FRA,FW,fr Ligue 1,30,1994,20.3,19,13,9,8,2,9,22,40.9,13,16,4,12,6,25,20,0,Gaetan LabordeNice
Augsburg,Nediljko Labrovic,1434,hr CRO,GK,de Bundesliga,24,1999,15.0,0,0,0,0,0,0,0,,0,0,0,0,0,0,12,1,Nediljko LabrovicAugsburg
Lyon,Alexandre Lacazette,1435,fr FRA,FW,fr Ligue 1,33,1991,22.8,13,6,3,7,3,5,16,31.3,11,13,3,10,8,21,7,0,Alexandre LacazetteLyon
Lille,Younes Lachaab,1436,fr FRA,"MF,FW",fr Ligue 1,19,2005,0.1,1,1,0,0,1,1,1,100.0,0,0,0,0,1,2,0,0,Younes LachaabLille
Crystal Palace,Maxence Lacroix,1437,fr FRA,DF,eng Premier League,24,2000,34.6,68,41,52,15,1,32,47,68.1,15,48,22,26,54,122,207,2,Maxence LacroixCrystal Palace
Nantes,Alban Lafont,1438,fr FRA,GK,fr Ligue 1,25,1999,12.0,1,1,1,0,0,1,1,100.0,0,2,0,2,0,1,8,1,Alban LafontNantes
Celta Vigo,Yoel Lago,1439,es ESP,DF,es La Liga,20,2004,6.5,12,8,8,3,1,7,9,77.8,2,5,4,1,4,16,30,0,Yoel LagoCelta Vigo
Bayern Munich,Konrad Laimer,1440,at AUT,DF,de Bundesliga,27,1997,18.9,49,27,19,22,8,23,48,47.9,25,24,1,23,8,57,24,1,Konrad LaimerBayern Munich
Gladbach,Stefan Lainer,1441,at AUT,DF,de Bundesliga,31,1992,8.4,22,13,16,5,1,12,14,85.7,2,12,6,6,12,34,30,0,Stefan LainerGladbach
Brest,Kenny Lala,1442,mg MAD,DF,fr Ligue 1,32,1991,29.8,66,42,36,23,7,38,57,66.7,19,25,9,16,25,91,75,2,Kenny LalaBrest
Southampton,Adam Lallana,1443,eng ENG,MF,eng Premier League,36,1988,4.0,8,5,4,4,0,2,12,16.7,10,4,1,3,5,13,5,0,Adam LallanaSouthampton
Hellas Verona,Mathis Lambourde,1444,fr FRA,"FW,MF",it Serie A,18,2006,1.0,3,1,2,1,0,1,3,33.3,2,3,0,3,0,3,1,0,Mathis LambourdeHellas Verona
Lille,Mohamed Lamine Bayo,1445,gn GUI,FW,fr Ligue 1,26,1998,3.4,1,1,0,0,1,1,1,100.0,0,0,0,0,0,1,4,0,Mohamed Lamine BayoLille
Brighton,Tariq Lamptey,1446,gh GHA,DF,eng Premier League,23,2000,9.6,17,11,8,9,0,9,25,36.0,16,15,7,8,7,24,23,1,Tariq LampteyBrighton
Tottenham,Will Lankshear,1447,eng ENG,"FW,MF",eng Premier League,19,2005,0.1,0,0,0,0,0,0,0,,0,0,0,0,0,0,0,0,Will LankshearTottenham
Cagliari,Gianluca Lapadula,1448,pe PER,"FW,MF",it Serie A,34,1990,3.4,2,0,1,0,1,0,1,0.0,1,0,0,0,0,2,1,0,Gianluca LapadulaCagliari
Mallorca,Cyle Larin,1449,ca CAN,FW,es La Liga,29,1995,19.6,12,6,1,6,5,3,9,33.3,6,12,3,9,1,13,16,0,Cyle LarinMallorca
Saint-Etienne,Gautier Larsonneur,1450,fr FRA,GK,fr Ligue 1,27,1997,34.0,1,0,1,0,0,0,2,0.0,2,1,0,1,0,1,25,1,Gautier LarsonneurSaint-Etienne
Eint Frankfurt,Hugo Larsson,1451,se SWE,MF,de Bundesliga,20,2004,26.6,47,27,17,25,5,21,42,50.0,21,42,11,31,30,77,35,1,Hugo LarssonEint Frankfurt
Valladolid,Juanmi Latasa,1452,es ESP,FW,es La Liga,23,2001,15.5,4,2,1,1,2,2,6,33.3,4,4,1,3,0,4,11,1,Juanmi LatasaValladolid
Mallorca,Toni Lato,1453,es ESP,DF,es La Liga,26,1997,6.9,17,11,6,5,6,7,11,63.6,4,10,4,6,6,23,33,0,Toni LatoMallorca
Chelsea,Romeo Lavia,1454,be BEL,MF,eng Premier League,20,2004,8.9,22,13,5,13,4,10,21,47.6,11,6,0,6,16,38,10,1,Romeo LaviaChelsea
Torino,Valentino Lazaro,1455,at AUT,"DF,FW",it Serie A,28,1996,25.6,26,12,10,12,4,15,30,50.0,15,28,5,23,11,37,38,1,Valentino LazaroTorino
Hellas Verona,Darko Lazovic,1456,rs SRB,"DF,MF",it Serie A,33,1990,16.2,21,10,5,14,2,11,28,39.3,17,19,3,16,11,32,39,0,Darko LazovicHellas Verona
Lazio,Manuel Lazzari,1457,it ITA,DF,it Serie A,30,1993,15.6,26,16,13,11,2,14,24,58.3,10,9,5,4,10,36,19,0,Manuel LazzariLazio
Brest,Julien Le Cardinal,1458,fr FRA,DF,fr Ligue 1,26,1997,15.3,27,15,16,8,3,11,16,68.8,5,18,14,4,33,60,75,0,Julien Le CardinalBrest
Brest,Jeremy Le Douaron,1459,fr FRA,FW,fr Ligue 1,26,1998,1.1,1,0,0,0,1,0,1,0.0,1,1,0,1,0,1,0,0,Jeremy Le DouaronBrest
Roma,Enzo Le Fee,1460,fr FRA,MF,it Serie A,24,2000,3.5,7,4,5,2,0,2,6,33.3,4,9,3,6,5,12,2,0,Enzo Le FeeRoma
Atletico Madrid,Robin Le Normand,1461,es ESP,DF,es La Liga,27,1996,23.9,27,18,23,4,0,12,20,60.0,8,20,9,11,10,37,120,1,Robin Le NormandAtletico Madrid
Genoa,Nicola Leali,1462,it ITA,GK,it Serie A,31,1993,29.0,0,0,0,0,0,0,0,,0,0,0,0,0,0,14,1,Nicola LealiGenoa
Milan,Rafael Leao,1463,pt POR,FW,it Serie A,25,1999,25.8,16,10,4,8,4,11,29,37.9,18,15,1,14,6,22,4,0,Rafael LeaoMilan
Montpellier,Benjamin Lecomte,1464,fr FRA,GK,fr Ligue 1,33,1991,30.0,0,0,0,0,0,0,0,,0,0,0,0,0,0,18,2,Benjamin LecomteMontpellier
Brest,Pierre Lees-Melou,1465,fr FRA,MF,fr Ligue 1,31,1993,17.0,48,33,20,19,9,25,54,46.3,29,19,3,16,12,60,23,0,Pierre Lees-MelouBrest
Angers,Jordan Lefort,1466,fr FRA,DF,fr Ligue 1,30,1993,34.0,52,30,42,9,1,30,44,68.2,14,56,37,19,32,84,206,3,Jordan LefortAngers
Union Berlin,Diogo Leite,1467,pt POR,DF,de Bundesliga,25,1999,28.3,64,32,43,17,4,33,50,66.0,17,61,25,36,57,121,162,1,Diogo LeiteUnion Berlin
Mainz 05,Maxim Leitsch,1468,de GER,DF,de Bundesliga,26,1998,7.5,12,4,6,4,2,7,9,77.8,2,12,4,8,10,22,42,1,Maxim LeitschMainz 05
Rayo Vallecano,Florian Lejeune,1469,fr FRA,DF,es La Liga,33,1991,36.9,46,28,30,14,2,23,43,53.5,20,38,32,6,41,87,181,1,Florian LejeuneRayo Vallecano
Monza,Stefan Lekovic,1470,rs SRB,DF,it Serie A,20,2004,4.1,9,4,6,2,1,5,13,38.5,8,4,4,0,7,16,5,0,Stefan LekovicMonza
Athletic Club,Inigo Lekue,1471,es ESP,DF,es La Liga,31,1993,8.6,15,12,12,3,0,9,17,52.9,8,7,2,5,9,24,29,2,Inigo LekueAthletic Club
Venezia,Nunzio Lella,1472,it ITA,MF,it Serie A,24,2000,0.1,0,0,0,0,0,0,0,,0,0,0,0,0,0,0,0,Nunzio LellaVenezia
Atletico Madrid,Thomas Lemar,1473,fr FRA,MF,es La Liga,28,1995,0.9,2,1,1,1,0,2,4,50.0,2,0,0,0,0,2,1,0,Thomas LemarAtletico Madrid
Strasbourg,Felix Lemarechal,1474,fr FRA,"MF,FW",fr Ligue 1,20,2003,19.8,35,24,13,17,5,14,29,48.3,15,35,4,31,14,49,19,0,Felix LemarechalStrasbourg
Wolves,Mario Lemina,1475,ga GAB,"MF,DF",eng Premier League,30,1993,15.2,51,31,27,19,5,20,29,69.0,9,12,7,5,27,78,50,3,Mario LeminaWolves
Atletico Madrid,Clement Lenglet,1476,fr FRA,DF,es La Liga,29,1995,21.9,27,17,19,8,0,11,15,73.3,4,24,18,6,22,49,104,1,Clement LengletAtletico Madrid
Fulham,Bernd Leno,1477,de GER,GK,eng Premier League,32,1992,38.0,2,2,2,0,0,2,2,100.0,0,1,0,1,0,2,11,5,Bernd LenoFulham
Auxerre,Donovan Leon,1478,gf GUF,GK,fr Ligue 1,31,1992,32.0,0,0,0,0,0,0,3,0.0,3,2,0,2,0,0,26,1,Donovan LeonAuxerre
Parma,Giovanni Leoni,1479,it ITA,DF,it Serie A,17,2006,13.3,14,6,10,4,0,5,10,50.0,5,20,11,9,15,29,63,1,Giovanni LeoniParma
Angers,Esteban Lepaul,1480,fr FRA,FW,fr Ligue 1,24,2000,18.1,11,6,2,6,3,4,16,25.0,12,15,2,13,4,15,10,0,Esteban LepaulAngers
Nantes,Johann Lepenant,1481,fr FRA,MF,fr Ligue 1,21,2002,22.8,68,33,30,27,11,32,71,45.1,39,35,3,32,18,86,25,0,Johann LepenantNantes
Crystal Palace,Jefferson Lerma,1482,co COL,"MF,DF",eng Premier League,29,1994,25.3,35,17,15,16,4,19,36,52.8,17,38,18,20,42,77,80,1,Jefferson LermaCrystal Palace
Nantes,Louis Leroux,1483,fr FRA,"MF,DF",fr Ligue 1,18,2006,9.1,25,18,10,12,3,16,22,72.7,6,22,2,20,8,33,19,1,Louis LerouxNantes
Barcelona,Robert Lewandowski,1484,pl POL,FW,es La Liga,35,1988,29.6,10,5,1,5,4,5,11,45.5,6,14,2,12,3,13,26,0,Robert LewandowskiBarcelona
Stuttgart,Jamie Leweling,1485,de GER,"MF,FW",de Bundesliga,23,2001,18.5,16,6,6,3,7,11,25,44.0,14,22,1,21,11,27,17,1,Jamie LewelingStuttgart
Manchester City,Rico Lewis,1486,eng ENG,"DF,MF",eng Premier League,19,2004,21.0,30,19,13,12,5,13,21,61.9,8,28,7,21,13,43,45,1,Rico LewisManchester City
Brentford,Keane Lewis-Potter,1487,eng ENG,"DF,FW",eng Premier League,23,2001,34.4,49,27,26,16,7,31,50,62.0,19,28,10,18,21,70,76,3,Keane Lewis-PotterBrentford
Arsenal,Myles Lewis-Skelly,1488,eng ENG,DF,eng Premier League,17,2006,15.2,22,14,10,9,3,10,11,90.9,1,4,1,3,7,29,27,0,Myles Lewis-SkellyArsenal
Como,Ben Lhassine Kone,1489,ci CIV,MF,it Serie A,24,2000,0.6,2,2,1,0,1,2,3,66.7,1,0,0,0,1,3,1,0,Ben Lhassine KoneComo
Milan,Mattia Liberali,1490,it ITA,MF,it Serie A,17,2007,0.7,2,1,0,1,1,2,2,100.0,0,0,0,0,0,2,0,0,Mattia LiberaliMilan
Freiburg,Philipp Lienhart,1491,at AUT,DF,de Bundesliga,28,1996,30.8,22,13,12,10,0,15,31,48.4,16,31,20,11,36,58,124,3,Philipp LienhartFreiburg
Manchester Utd,Matthijs de Ligt,1492,nl NED,DF,eng Premier League,24,1999,23.6,30,22,17,12,1,23,32,71.9,9,29,21,8,33,63,96,0,Matthijs de LigtManchester Utd
Wolves,Pedro Lima,1493,br BRA,DF,eng Premier League,18,2006,0.8,1,0,0,0,1,1,3,33.3,2,0,0,0,2,3,5,0,Pedro LimaWolves
Manchester Utd,Victor Lindelof,1494,se SWE,DF,eng Premier League,30,1994,7.8,7,2,5,1,1,3,4,75.0,1,6,4,2,8,15,36,2,Victor LindelofManchester Utd
Everton,Jesper Lindstrom,1495,dk DEN,FW,eng Premier League,24,2000,13.8,45,25,24,19,2,19,55,34.5,36,15,3,12,12,57,17,0,Jesper LindstromEverton
Torino,Karol Linetty,1496,pl POL,MF,it Serie A,29,1995,17.1,39,23,17,19,3,20,41,48.8,21,14,5,9,12,51,31,1,Karol LinettyTorino
Atletico Madrid,Samuel Lino,1497,br BRA,"MF,DF",es La Liga,24,1999,17.2,33,17,25,4,4,22,52,42.3,30,23,4,19,8,41,13,0,Samuel LinoAtletico Madrid
Marseille,Pol Lirola,1498,es ESP,DF,fr Ligue 1,26,1997,7.6,13,9,5,8,0,5,13,38.5,8,7,2,5,4,17,12,0,Pol LirolaMarseille
Hellas Verona,Dailon Livramento,1499,cv CPV,"FW,MF",it Serie A,23,2001,10.4,15,11,2,7,6,7,13,53.8,6,10,2,8,3,18,9,0,Dailon LivramentoHellas Verona
Newcastle Utd,Valentino Livramento,1500,eng ENG,DF,eng Premier League,21,2002,31.6,54,36,35,15,4,32,59,54.2,27,37,11,26,23,77,108,1,Valentino LivramentoNewcastle Utd
Union Berlin,Marin Ljubicic,1501,hr CRO,"FW,MF",de Bundesliga,22,2002,3.1,2,1,0,2,0,1,3,33.3,2,2,0,2,0,2,7,0,Marin LjubicicUnion Berlin
Mallorca,Javier Llabres,1502,es ESP,FW,es La Liga,21,2002,0.6,0,0,0,0,0,0,0,,0,1,0,1,0,0,0,0,Javier LlabresMallorca
Betis,Diego Llorente,1503,es ESP,DF,es La Liga,30,1993,28.0,36,20,23,12,1,25,38,65.8,13,29,20,9,43,79,154,1,Diego LlorenteBetis
Atletico Madrid,Marcos Llorente,1504,es ESP,"DF,MF",es La Liga,29,1995,27.9,69,52,38,27,4,36,55,65.5,19,32,7,25,27,96,51,1,Marcos LlorenteAtletico Madrid
Le Havre,Gautier Lloris,1505,fr FRA,DF,fr Ligue 1,29,1995,30.8,68,43,52,16,0,38,53,71.7,15,33,21,12,34,102,192,0,Gautier LlorisLe Havre
Betis,Giovani Lo Celso,1506,ar ARG,"MF,FW",es La Liga,28,1996,16.2,34,22,8,17,9,17,25,68.0,8,14,2,12,5,39,3,1,Giovani Lo CelsoBetis
Napoli,Stanislav Lobotka,1507,sk SVK,MF,it Serie A,29,1994,29.3,47,30,16,21,10,19,31,61.3,12,29,11,18,21,68,57,1,Stanislav LobotkaNapoli
Juventus,Manuel Locatelli,1508,it ITA,MF,it Serie A,26,1998,31.4,72,49,29,35,8,32,56,57.1,24,58,20,38,23,95,77,0,Manuel LocatelliJuventus
Brest,Bradley Locko,1509,fr FRA,DF,fr Ligue 1,22,2002,1.1,2,2,1,1,0,1,1,100.0,0,3,2,1,1,3,3,0,Bradley LockoBrest
Milan,Ruben Loftus-Cheek,1510,eng ENG,MF,it Serie A,28,1996,11.5,19,8,6,9,4,6,12,50.0,6,3,0,3,3,22,20,0,Ruben Loftus-CheekMilan
Le Havre,Elysee Logbo,1511,fr FRA,FW,fr Ligue 1,20,2004,0.3,0,0,0,0,0,0,0,,0,0,0,0,0,0,0,0,Elysee LogboLe Havre
Las Palmas,Enzo Loiodice,1512,fr FRA,MF,es La Liga,23,2000,7.6,17,7,8,9,0,3,10,30.0,7,4,1,3,10,27,7,2,Enzo LoiodiceLas Palmas
Newcastle Utd,Sean Longstaff,1513,eng ENG,MF,eng Premier League,26,1997,8.9,27,16,10,9,8,18,27,66.7,9,17,5,12,7,34,8,0,Sean LongstaffNewcastle Utd
Atalanta,Ademola Lookman,1514,ng NGA,"MF,FW",it Serie A,26,1997,25.0,32,15,9,15,8,11,19,57.9,8,19,0,19,3,35,5,1,Ademola LookmanAtalanta
Nantes,Anthony Lopes,1515,pt POR,GK,fr Ligue 1,33,1990,17.4,1,0,1,0,0,1,1,100.0,0,0,0,0,1,2,7,1,Anthony LopesNantes
Mallorca,David Lopez,1516,es ESP,DF,es La Liga,21,2003,1.9,3,2,3,0,0,2,2,100.0,0,2,2,0,1,4,10,0,David LopezMallorca
Girona,David Lopez,1517,es ESP,DF,es La Liga,34,1989,27.0,32,24,22,7,3,18,31,58.1,13,22,12,10,14,46,111,2,David LopezGirona
Valencia,Diego Lopez,1518,es ESP,"MF,FW",es La Liga,22,2002,30.4,31,18,11,16,4,16,47,34.0,31,30,0,30,16,47,15,0,Diego LopezValencia
Celta Vigo,Fer Lopez,1519,,"FW,MF",es La Liga,,,7.5,9,5,1,6,2,2,13,15.4,11,10,0,10,2,11,7,0,Fer LopezCelta Vigo
Barcelona,Fermin Lopez,1520,es ESP,"MF,FW",es La Liga,21,2003,13.9,19,15,3,9,7,8,32,25.0,24,11,0,11,5,24,3,0,Fermin LopezBarcelona
Real Sociedad,Javi Lopez,1521,es ESP,DF,es La Liga,22,2002,21.5,40,23,23,12,5,23,37,62.2,14,21,7,14,11,51,59,2,Javi LopezReal Sociedad
Girona,Pau Lopez,1522,es ESP,GK,es La Liga,29,1994,0.5,0,0,0,0,0,0,0,,0,0,0,0,0,0,1,0,Pau LopezGirona
Leganes,Roberto Lopez,1523,es ESP,MF,es La Liga,24,2000,4.4,8,6,4,4,0,5,15,33.3,10,5,0,5,1,9,7,2,Roberto LopezLeganes
Rayo Vallecano,Unai Lopez,1524,es ESP,MF,es La Liga,28,1995,19.0,31,21,14,12,5,17,36,47.2,19,18,6,12,21,52,20,0,Unai LopezRayo Vallecano
Celta Vigo,Iker Losada,1525,es ESP,"FW,MF",es La Liga,22,2001,4.0,3,3,0,1,2,1,5,20.0,4,4,1,3,1,4,8,0,Iker LosadaCelta Vigo
Betis,Iker Losada,1526,es ESP,"MF,FW",es La Liga,22,2001,3.7,10,7,2,4,4,5,10,50.0,5,2,0,2,3,13,2,0,Iker LosadaBetis
Bochum,Anthony Losilla,1527,fr FRA,MF,de Bundesliga,38,1986,12.6,30,16,15,12,3,17,33,51.5,16,22,7,15,18,48,27,1,Anthony LosillaBochum
Nice,Jordan Lotomba,1528,ch SUI,"MF,DF",fr Ligue 1,25,1998,0.4,0,0,0,0,0,0,0,,0,0,0,0,0,0,1,0,Jordan LotombaNice
Nice,Tom Louchet,1529,fr FRA,"DF,MF",fr Ligue 1,21,2003,8.6,27,17,17,5,5,17,23,73.9,6,12,4,8,18,45,20,0,Tom LouchetNice
Udinese,Sandi Lovric,1530,si SVN,MF,it Serie A,26,1998,25.6,46,29,25,17,4,22,44,50.0,22,33,5,28,22,68,27,1,Sandi LovricUdinese
Espanyol,Pol Lozano,1531,es ESP,MF,es La Liga,24,1999,21.6,53,34,23,25,5,25,58,43.1,33,32,6,26,22,75,31,0,Pol LozanoEspanyol
Udinese,Lorenzo Lucca,1532,it ITA,FW,it Serie A,23,2000,26.1,10,6,3,2,5,5,11,45.5,6,18,1,17,7,17,27,0,Lorenzo LuccaUdinese
Bologna,Jhon Lucumi,1533,co COL,DF,it Serie A,26,1998,29.0,53,30,23,29,1,29,41,70.7,12,32,14,18,26,79,88,7,Jhon LucumiBologna
Dortmund,Yannik Luhrs,1534,de GER,DF,de Bundesliga,20,2003,1.4,1,1,1,0,0,0,0,,0,0,0,0,2,3,4,0,Yannik LuhrsDortmund
Valencia,Jose Luis Gaya,1535,es ESP,DF,es La Liga,29,1995,20.0,57,40,39,15,3,40,58,69.0,18,16,2,14,25,82,61,0,Jose Luis GayaValencia
Cagliari,Jose Luis Palomino,1536,ar ARG,DF,it Serie A,34,1990,12.0,27,15,16,9,2,15,21,71.4,6,21,11,10,22,49,46,0,Jose Luis PalominoCagliari
Juventus,Douglas Luiz,1537,br BRA,MF,it Serie A,26,1998,5.9,13,8,7,5,1,6,9,66.7,3,5,2,3,4,17,5,0,Douglas LuizJuventus
Napoli,Romelu Lukaku,1538,be BEL,FW,it Serie A,31,1993,31.6,4,2,0,2,2,1,4,25.0,3,7,2,5,1,5,17,0,Romelu LukakuNapoli
RB Leipzig,Castello Lukeba,1539,fr FRA,DF,de Bundesliga,21,2002,17.5,31,17,15,12,4,17,24,70.8,7,29,12,17,17,48,74,0,Castello LukebaRB Leipzig
Sevilla,Dodi Lukebakio,1540,be BEL,FW,es La Liga,26,1997,34.4,22,14,8,8,6,15,27,55.6,12,18,1,17,11,33,17,2,Dodi LukebakioSevilla
Fulham,Sasa Lukic,1541,rs SRB,MF,eng Premier League,27,1996,26.0,68,39,22,40,6,23,55,41.8,32,20,7,13,28,96,35,1,Sasa LukicFulham
Strasbourg,Milos Lukovic,1542,rs SRB,"FW,MF",fr Ligue 1,18,2005,0.1,0,0,0,0,0,0,0,,0,0,0,0,0,0,0,0,Milos LukovicStrasbourg
Southampton,Joe Lumley,1543,eng ENG,GK,eng Premier League,29,1995,3.0,0,0,0,0,0,0,0,,0,0,0,0,0,0,3,3,Joe LumleySouthampton
Mallorca,Daniel Luna,1544,co COL,MF,es La Liga,21,2003,0.2,0,0,0,0,0,0,0,,0,1,0,1,0,0,0,0,Daniel LunaMallorca
Real Madrid,Andriy Lunin,1545,ua UKR,GK,es La Liga,25,1999,7.0,1,0,1,0,0,0,0,,0,0,0,0,0,1,3,0,Andriy LuninReal Madrid
Ipswich Town,Massimo Luongo,1546,au AUS,MF,eng Premier League,31,1992,2.2,9,6,6,2,1,5,8,62.5,3,4,2,2,2,11,2,0,Massimo LuongoIpswich Town
Cagliari,Sebastiano Luperto,1547,it ITA,DF,it Serie A,27,1996,36.0,48,27,31,16,1,18,28,64.3,10,30,15,15,33,81,161,1,Sebastiano LupertoCagliari
Cagliari,Zito Luvumbo,1548,ao ANG,"FW,MF",it Serie A,22,2002,17.8,10,6,4,3,3,6,19,31.6,13,5,0,5,4,14,4,0,Zito LuvumboCagliari
Bologna,Charalampos Lykogiannis,1549,gr GRE,DF,it Serie A,30,1993,11.6,23,14,14,8,1,10,20,50.0,10,10,5,5,11,34,41,1,Charalampos LykogiannisBologna
Werder Bremen,Senne Lynen,1550,be BEL,MF,de Bundesliga,25,1999,30.4,72,39,36,30,6,39,69,56.5,30,56,13,43,65,137,75,5,Senne LynenWerder Bremen
Parma,Mathias Lovik,1551,no NOR,"DF,FW",it Serie A,20,2003,1.0,1,0,0,1,0,1,3,33.3,2,1,1,0,2,3,3,0,Mathias LovikParma
Montpellier,Othmane Maamma,1552,ma MAR,"FW,MF",fr Ligue 1,18,2005,4.0,3,1,2,1,0,1,4,25.0,3,4,0,4,1,4,2,1,Othmane MaammaMontpellier
Aston Villa,Ian Maatsen,1553,nl NED,DF,eng Premier League,22,2002,12.7,29,17,17,9,3,17,24,70.8,7,13,0,13,15,44,39,3,Ian MaatsenAston Villa
Liverpool,Alexis Mac Allister,1554,ar ARG,MF,eng Premier League,25,1998,28.9,95,58,28,51,16,55,104,52.9,49,61,6,55,22,117,29,1,Alexis Mac AllisterLiverpool
Lens,Deiver Machado,1555,co COL,"DF,MF",fr Ligue 1,30,1993,20.1,36,26,14,14,8,17,30,56.7,13,20,4,16,16,52,34,2,Deiver MachadoLens
Angers,Lanroy Machine,1556,fr FRA,FW,fr Ligue 1,18,2005,0.1,0,0,0,0,0,0,0,,0,0,0,0,0,0,0,0,Lanroy MachineAngers
Holstein Kiel,Shuto Machino,1557,jp JPN,"FW,MF",de Bundesliga,24,1999,21.7,8,5,4,3,1,6,16,37.5,10,12,3,9,7,15,28,1,Shuto MachinoHolstein Kiel
Valladolid,Darwin Machis,1558,ve VEN,"MF,FW",es La Liga,31,1993,7.1,5,4,3,2,0,3,9,33.3,6,3,0,3,5,10,13,0,Darwin MachisValladolid
Saint-Etienne,Yvann Macon,1559,fr FRA,DF,fr Ligue 1,25,1998,8.8,19,11,9,7,3,10,21,47.6,11,14,4,10,2,21,10,1,Yvann MaconSaint-Etienne
Tottenham,James Maddison,1560,eng ENG,MF,eng Premier League,27,1996,20.1,31,19,8,16,7,9,29,31.0,20,15,4,11,12,43,19,1,James MaddisonTottenham
Auxerre,Eros Maddy,1561,nl NED,DF,fr Ligue 1,23,2001,0.2,0,0,0,0,0,0,0,,0,0,0,0,0,0,0,0,Eros MaddyAuxerre
Chelsea,Noni Madueke,1562,eng ENG,FW,eng Premier League,22,2002,22.6,25,18,8,12,5,14,38,36.8,24,17,0,17,10,35,11,0,Noni MaduekeChelsea
Mallorca,Pablo Maffeo,1563,es ESP,DF,es La Liga,27,1997,26.3,60,40,43,14,3,34,46,73.9,12,32,11,21,25,85,103,1,Pablo MaffeoMallorca
Arsenal,Gabriel Magalhaes,1564,br BRA,DF,eng Premier League,26,1997,26.3,25,15,12,8,5,12,16,75.0,4,42,29,13,16,41,93,2,Gabriel MagalhaesArsenal
Monaco,Soungoutou Magassa,1565,fr FRA,MF,fr Ligue 1,20,2003,11.4,47,25,14,27,6,25,46,54.3,21,16,3,13,21,68,19,1,Soungoutou MagassaMonaco
Brentford,Edmond-Paris Maghoma,1566,eng ENG,"MF,FW",eng Premier League,23,2001,1.3,2,1,0,2,0,1,3,33.3,2,2,2,0,1,3,2,0,Edmond-Paris MaghomaBrentford
Hellas Verona,Giangiacomo Magnani,1567,it ITA,DF,it Serie A,28,1995,11.8,20,15,14,6,0,7,7,100.0,0,16,9,7,17,37,73,1,Giangiacomo MagnaniHellas Verona
Brest,Hugo Magnetti,1568,fr FRA,MF,fr Ligue 1,26,1998,25.8,52,32,21,27,4,23,51,45.1,28,20,3,17,18,70,37,0,Hugo MagnettiBrest
Toulouse,Frank Magri,1569,cm CMR,"FW,MF",fr Ligue 1,24,1999,16.8,8,2,1,6,1,3,8,37.5,5,16,2,14,4,12,11,0,Frank MagriToulouse
Manchester Utd,Harry Maguire,1570,eng ENG,DF,eng Premier League,31,1993,19.5,30,15,23,6,1,17,23,73.9,6,15,12,3,40,70,78,1,Harry MaguireManchester Utd
Real Sociedad,Jon Magunazelaia,1571,es ESP,MF,es La Liga,23,2001,0.1,1,1,1,0,0,0,0,,0,0,0,0,0,1,0,0,Jon MagunazelaiaReal Sociedad
Augsburg,Arne Maier,1572,de GER,MF,de Bundesliga,25,1999,10.4,13,7,4,8,1,7,13,53.8,6,15,1,14,6,19,14,1,Arne MaierAugsburg
Milan,Mike Maignan,1573,fr FRA,GK,it Serie A,29,1995,36.6,0,0,0,0,0,0,1,0.0,1,1,0,1,0,0,19,3,Mike MaignanMilan
Heidenheim,Patrick Mainka,1574,de GER,DF,de Bundesliga,29,1994,34.0,58,30,36,20,2,35,55,63.6,20,61,36,25,68,126,206,0,Patrick MainkaHeidenheim
Manchester Utd,Kobbie Mainoo,1575,eng ENG,MF,eng Premier League,19,2005,18.3,46,29,18,14,14,24,40,60.0,16,16,2,14,19,65,14,1,Kobbie MainooManchester Utd
Lyon,Ainsley Maitland-Niles,1576,eng ENG,DF,fr Ligue 1,26,1997,22.1,71,44,30,26,15,48,76,63.2,28,28,4,24,25,96,61,6,Ainsley Maitland-NilesLyon
Monaco,Radoslaw Majecki,1577,pl POL,GK,fr Ligue 1,24,1999,15.0,0,0,0,0,0,0,2,0.0,2,0,0,0,0,0,8,1,Radoslaw MajeckiMonaco
Wolfsburg,Lovro Majer,1578,hr CRO,MF,de Bundesliga,26,1998,3.4,2,1,0,1,1,1,5,20.0,4,5,1,4,1,3,2,1,Lovro MajerWolfsburg
Brest,Hamidou Makalou,1579,ml MLI,"FW,MF",fr Ligue 1,18,2006,0.4,0,0,0,0,0,0,0,,0,0,0,0,0,0,0,0,Hamidou MakalouBrest
Freiburg,Jordy Makengo,1580,fr FRA,DF,de Bundesliga,22,2001,8.3,16,9,10,5,1,10,16,62.5,6,8,3,5,7,23,29,0,Jordy MakengoFreiburg
Cagliari,Antoine Makoumbou,1581,cg CGO,MF,it Serie A,26,1998,23.9,42,23,28,11,3,19,25,76.0,6,26,5,21,17,59,28,0,Antoine MakoumbouCagliari
Montpellier,Nikola Maksimovic,1582,rs SRB,DF,fr Ligue 1,32,1991,6.5,9,5,6,3,0,6,7,85.7,1,5,4,1,6,15,30,1,Nikola MaksimovicMontpellier
Manchester Utd,Tyrell Malacia,1583,nl NED,DF,eng Premier League,24,1999,1.1,2,1,2,0,0,1,2,50.0,1,0,0,0,1,3,1,1,Tyrell MalaciaManchester Utd
Stuttgart,Jarzinho Malanga,1584,de GER,DF,de Bundesliga,18,2006,0.0,0,0,0,0,0,0,0,,0,0,0,0,0,0,0,0,Jarzinho MalangaStuttgart
Werder Bremen,Julian Malatini,1585,ar ARG,DF,de Bundesliga,23,2001,5.0,11,9,5,5,1,5,11,45.5,6,8,3,5,7,18,17,0,Julian MalatiniWerder Bremen
Monza,Daniel Maldini,1586,it ITA,"MF,FW",it Serie A,22,2001,14.5,14,6,5,9,0,6,13,46.2,7,8,2,6,4,18,12,2,Daniel MaldiniMonza
Atalanta,Daniel Maldini,1587,it ITA,"FW,MF",it Serie A,22,2001,2.9,2,2,0,1,1,1,2,50.0,1,1,0,1,2,4,3,0,Daniel MaldiniAtalanta
Empoli,Youssef Maleh,1588,ma MAR,MF,it Serie A,25,1998,16.8,45,23,17,23,5,17,34,50.0,17,25,6,19,16,61,25,0,Youssef MalehEmpoli
Aston Villa,Donyell Malen,1589,nl NED,FW,eng Premier League,25,1999,3.4,7,4,3,3,1,1,4,25.0,3,2,0,2,0,7,1,0,Donyell MalenAston Villa
Dortmund,Donyell Malen,1590,nl NED,"FW,MF",de Bundesliga,25,1999,6.8,0,0,0,0,0,0,2,0.0,2,2,0,2,3,3,6,0,Donyell MalenDortmund
Genoa,Ruslan Malinovskyi,1591,ua UKR,"MF,FW",it Serie A,31,1993,4.3,12,8,4,7,1,3,6,50.0,3,2,0,2,1,13,4,0,Ruslan MalinovskyiGenoa
Heidenheim,Lennard Maloney,1592,us USA,MF,de Bundesliga,24,1999,8.4,20,11,12,7,1,14,23,60.9,9,9,2,7,14,34,38,0,Lennard MaloneyHeidenheim
Mainz 05,Lennard Maloney,1593,us USA,MF,de Bundesliga,24,1999,0.3,2,1,0,1,1,1,1,100.0,0,2,0,2,0,2,3,0,Lennard MaloneyMainz 05
Lille,Aaron Malouda,1594,fr FRA,FW,fr Ligue 1,18,2005,0.0,0,0,0,0,0,0,0,,0,0,0,0,0,0,0,0,Aaron MaloudaLille
Valencia,Giorgi Mamardashvili,1595,ge GEO,GK,es La Liga,23,2000,34.0,2,2,2,0,0,2,3,66.7,1,0,0,0,1,3,16,3,Giorgi MamardashviliValencia
Parma,Dennis Man,1596,ro ROU,"FW,MF",it Serie A,25,1998,22.2,13,6,7,3,3,6,24,25.0,18,15,3,12,8,21,11,0,Dennis ManParma
Brest,Hianga Mananga Mbock,1597,fr FRA,MF,fr Ligue 1,24,1999,0.2,0,0,0,0,0,0,0,,0,0,0,0,1,1,0,0,Hianga Mananga MbockBrest
Roma,Gianluca Mancini,1598,it ITA,DF,it Serie A,28,1996,34.9,42,26,22,18,2,20,34,58.8,14,22,16,6,35,77,103,0,Gianluca ManciniRoma
Rennes,Steve Mandanda,1599,fr FRA,GK,fr Ligue 1,39,1985,16.5,0,0,0,0,0,0,1,0.0,1,0,0,0,0,0,6,2,Steve MandandaRennes
Lazio,Christos Mandas,1600,gr GRE,GK,it Serie A,22,2001,9.0,0,0,0,0,0,0,0,,0,0,0,0,0,0,4,0,Christos MandasLazio
Atletico Madrid,Reinildo Mandava,1601,mz MOZ,DF,es La Liga,30,1994,10.5,18,11,10,7,1,10,18,55.6,8,11,5,6,16,34,35,0,Reinildo MandavaAtletico Madrid
Lille,Aissa Mandi,1602,dz ALG,DF,fr Ligue 1,32,1991,19.3,31,17,12,15,4,16,22,72.7,6,23,11,12,15,46,54,0,Aissa MandiLille
Fiorentina,Rolando Mandragora,1603,it ITA,MF,it Serie A,27,1997,20.6,23,13,9,12,2,14,31,45.2,17,22,7,15,15,38,54,1,Rolando MandragoraFiorentina
Wolves,Mateus Mane,1604,,MF,eng Premier League,,,0.0,0,0,0,0,0,0,0,,0,1,0,1,0,0,0,0,Mateus ManeWolves
Everton,Orel Mangala,1605,be BEL,MF,eng Premier League,26,1998,14.0,16,8,3,11,2,5,8,62.5,3,8,3,5,21,37,24,1,Orel MangalaEverton
Lyon,Orel Mangala,1606,be BEL,MF,fr Ligue 1,26,1998,0.7,1,0,0,0,1,0,1,0.0,1,2,0,2,0,1,1,0,Orel MangalaLyon
Southampton,Ryan Manning,1607,ie IRL,"DF,MF",eng Premier League,28,1996,16.2,28,17,16,10,2,14,26,53.8,12,20,11,9,17,45,47,0,Ryan ManningSouthampton
Celta Vigo,Javier Manquillo,1608,es ESP,DF,es La Liga,30,1994,5.7,7,5,4,3,0,2,10,20.0,8,5,3,2,7,14,14,0,Javier ManquilloCelta Vigo
Freiburg,Johan Manzambi,1609,ch SUI,"FW,MF",de Bundesliga,18,2005,3.7,8,2,1,3,4,1,4,25.0,3,6,0,6,4,12,7,0,Johan ManzambiFreiburg
Atalanta,Alberto Manzoni,1610,it ITA,MF,it Serie A,19,2005,0.1,0,0,0,0,0,0,0,,0,0,0,0,0,0,0,0,Alberto ManzoniAtalanta
Strasbourg,Sekou Mara,1611,fr FRA,"FW,MF",fr Ligue 1,22,2002,8.5,9,6,0,5,4,3,9,33.3,6,11,0,11,3,12,3,0,Sekou MaraStrasbourg
Genoa,Alessandro Marcandalli,1612,it ITA,DF,it Serie A,21,2002,0.5,1,0,1,0,0,0,0,,0,0,0,0,0,1,2,0,Alessandro MarcandalliGenoa
Venezia,Alessandro Marcandalli,1613,it ITA,DF,it Serie A,21,2002,3.9,8,6,6,2,0,3,6,50.0,3,6,3,3,2,10,26,0,Alessandro MarcandalliVenezia
Sevilla,Marcao,1614,br BRA,DF,es La Liga,28,1996,6.1,10,7,6,4,0,3,5,60.0,2,9,6,3,7,17,29,1,MarcaoSevilla
Brighton,Solly March,1615,eng ENG,"FW,MF",eng Premier League,30,1994,1.9,6,3,2,2,2,5,8,62.5,3,3,0,3,2,8,2,1,Solly MarchBrighton
Lecce,Filip Marchwinski,1616,pl POL,MF,it Serie A,22,2002,0.2,0,0,0,0,0,0,0,,0,0,0,0,0,0,0,0,Filip MarchwinskiLecce
Athletic Club,Oscar de Marcos,1617,es ESP,DF,es La Liga,35,1989,17.4,32,15,15,13,4,21,37,56.8,16,17,1,16,16,48,35,0,Oscar de MarcosAthletic Club
Valencia,Alberto Mari,1618,es ESP,FW,es La Liga,23,2001,0.1,0,0,0,0,0,0,0,,0,0,0,0,0,0,0,0,Alberto MariValencia
Monza,Pablo Mari,1619,es ESP,DF,it Serie A,30,1993,18.1,26,15,14,12,0,11,21,52.4,10,24,21,3,37,63,85,2,Pablo MariMonza
Fiorentina,Pablo Mari,1620,es ESP,DF,it Serie A,30,1993,12.2,14,9,11,3,0,6,11,54.5,5,19,14,5,25,39,94,0,Pablo MariFiorentina
Atletico Madrid,Jose Maria Gimenez,1621,uy URU,DF,es La Liga,29,1995,22.2,26,16,18,8,0,17,28,60.7,11,29,19,10,27,53,115,2,Jose Maria GimenezAtletico Madrid
Empoli,Luca Marianucci,1622,it ITA,DF,it Serie A,20,2004,11.9,28,12,17,11,0,11,19,57.9,8,16,8,8,19,47,63,1,Luca MarianucciEmpoli
Monza,Mirko Maric,1623,hr CRO,"FW,MF",it Serie A,29,1995,1.2,1,0,1,0,0,1,2,50.0,1,1,1,0,1,2,1,0,Mirko MaricMonza
Venezia,Mirko Maric,1624,hr CRO,FW,it Serie A,29,1995,4.0,6,3,5,1,0,2,5,40.0,3,3,1,2,1,7,10,0,Mirko MaricVenezia
Real Sociedad,Arkaitz Mariezkurrena,1625,es ESP,"FW,MF",es La Liga,19,2005,2.7,1,0,1,0,0,0,4,0.0,4,4,1,3,1,2,4,0,Arkaitz MariezkurrenaReal Sociedad
Napoli,Rafa Marin,1626,es ESP,DF,it Serie A,22,2002,1.6,1,0,1,0,0,1,2,50.0,1,1,1,0,1,2,4,0,Rafa MarinNapoli
Real Sociedad,Pablo Marin,1627,es ESP,MF,es La Liga,21,2003,13.8,25,17,6,13,6,10,19,52.6,9,12,3,9,5,30,14,0,Pablo MarinReal Sociedad
Cagliari,Razvan Marin,1628,ro ROU,MF,it Serie A,28,1996,15.6,22,13,8,11,3,13,25,52.0,12,7,0,7,2,24,20,2,Razvan MarinCagliari
Torino,Guillermo Maripan,1629,cl CHI,DF,it Serie A,30,1994,26.0,40,23,25,14,1,21,33,63.6,12,27,13,14,41,81,138,1,Guillermo MaripanTorino
Las Palmas,Mika Marmol,1630,es ESP,DF,es La Liga,23,2001,26.7,61,29,35,24,2,34,52,65.4,18,46,14,32,38,99,121,2,Mika MarmolLas Palmas
Manchester City,Omar Marmoush,1631,eg EGY,"FW,MF",eng Premier League,25,1999,13.1,13,8,2,9,2,8,16,50.0,8,15,1,14,6,19,3,0,Omar MarmoushManchester City
Eint Frankfurt,Omar Marmoush,1632,eg EGY,FW,de Bundesliga,25,1999,16.1,12,8,0,3,9,3,7,42.9,4,7,1,6,2,14,2,0,Omar MarmoushEint Frankfurt
Valladolid,Mario Maroto,1633,es ESP,MF,es La Liga,20,2003,0.7,0,0,0,0,0,0,2,0.0,2,0,0,0,2,2,2,0,Mario MarotoValladolid
Paris S-G,Marquinhos,1634,br BRA,DF,fr Ligue 1,30,1994,19.2,30,19,8,16,6,25,33,75.8,8,27,15,12,11,41,64,0,MarquinhosParis S-G
Real Sociedad,Unai Marrero,1635,es ESP,GK,es La Liga,22,2001,2.0,0,0,0,0,0,0,0,,0,0,0,0,0,0,1,0,Unai MarreroReal Sociedad
Reims,Ange Martial Tia,1636,ml MLI,"MF,DF",fr Ligue 1,17,2006,1.9,4,3,1,2,1,2,6,33.3,4,3,0,3,2,6,4,0,Ange Martial TiaReims
Genoa,Aaron Martin,1637,es ESP,DF,it Serie A,27,1997,34.3,71,47,41,26,4,33,51,64.7,18,33,11,22,19,90,73,1,Aaron MartinGenoa
Alaves,Carlos Martin,1638,es ESP,"FW,MF",es La Liga,22,2002,14.8,43,21,18,16,9,13,49,26.5,36,30,1,29,5,48,20,0,Carlos MartinAlaves
Las Palmas,Diego Martin,1639,es ESP,FW,es La Liga,20,2003,0.4,1,1,0,0,1,1,1,100.0,0,0,0,0,0,1,1,0,Diego MartinLas Palmas
Barcelona,Gerard Martin,1640,es ESP,DF,es La Liga,22,2002,11.5,22,10,10,7,5,11,16,68.8,5,16,2,14,13,35,27,0,Gerard MartinBarcelona
Girona,Ivan Martin,1641,es ESP,MF,es La Liga,25,1999,22.7,32,19,14,14,4,15,34,44.1,19,20,6,14,11,43,15,1,Ivan MartinGirona
Real Sociedad,Jon Martin,1642,es ESP,DF,es La Liga,18,2006,10.0,11,9,7,3,1,6,9,66.7,3,13,9,4,7,18,80,1,Jon MartinReal Sociedad
Brest,Jonas Martin,1643,fr FRA,MF,fr Ligue 1,34,1990,5.5,13,7,10,2,1,6,11,54.5,5,4,1,3,8,21,12,1,Jonas MartinBrest
Valladolid,Mario Martin,1644,es ESP,MF,es La Liga,20,2004,19.4,62,32,31,27,4,21,49,42.9,28,32,7,25,21,83,46,7,Mario MartinValladolid
Arsenal,Gabriel Martinelli,1645,br BRA,"FW,MF",eng Premier League,23,2001,25.4,23,15,9,6,8,7,23,30.4,16,15,0,15,5,28,19,0,Gabriel MartinelliArsenal
Girona,Arnau Martinez,1646,es ESP,"DF,MF",es La Liga,21,2003,29.2,51,28,30,15,6,32,63,50.8,31,18,6,12,31,82,76,2,Arnau MartinezGirona
Aston Villa,Emiliano Martinez,1647,ar ARG,GK,eng Premier League,31,1992,35.5,3,3,3,0,0,2,2,100.0,0,1,0,1,0,3,17,6,Emiliano MartinezAston Villa
Barcelona,Inigo Martinez,1648,es ESP,DF,es La Liga,33,1991,27.7,25,14,20,5,0,16,22,72.7,6,18,7,11,18,43,108,1,Inigo MartinezBarcelona
Osasuna,Javi Martinez,1649,es ESP,MF,es La Liga,24,1999,0.1,0,0,0,0,0,0,0,,0,0,0,0,0,0,0,0,Javi MartinezOsasuna
Inter,Josep Martinez,1650,es ESP,GK,it Serie A,26,1998,5.0,0,0,0,0,0,0,0,,0,0,0,0,0,0,0,0,Josep MartinezInter
Inter,Lautaro Martinez,1651,ar ARG,FW,it Serie A,26,1997,27.5,30,16,10,12,8,13,25,52.0,12,21,3,18,10,40,15,0,Lautaro MartinezInter
Manchester Utd,Lisandro Martinez,1652,ar ARG,DF,eng Premier League,26,1998,19.5,40,24,25,12,3,21,36,58.3,15,22,8,14,32,72,57,1,Lisandro MartinezManchester Utd
Fiorentina,Lucas Martinez Quarta,1653,ar ARG,DF,it Serie A,28,1996,3.9,12,7,9,3,0,8,13,61.5,5,5,2,3,3,15,25,1,Lucas Martinez QuartaFiorentina
Sevilla,Ramon Martinez,1654,es ESP,DF,es La Liga,21,2002,2.9,6,3,5,1,0,3,5,60.0,2,2,1,1,2,8,23,0,Ramon MartinezSevilla
Alaves,Toni Martinez,1655,es ESP,FW,es La Liga,27,1997,11.2,12,7,5,4,3,4,8,50.0,4,8,2,6,1,13,15,0,Toni MartinezAlaves
Monza,Kevin Martins,1656,it ITA,"MF,DF",it Serie A,19,2005,2.0,5,4,3,2,0,3,6,50.0,3,1,0,1,1,6,4,1,Kevin MartinsMonza
Athletic Club,Javi Marton,1657,es ESP,"FW,MF",es La Liga,25,1999,0.6,0,0,0,0,0,0,0,,0,0,0,0,0,0,0,0,Javi MartonAthletic Club
Lazio,Adam Marusic,1658,me MNE,DF,it Serie A,31,1992,26.0,32,20,18,12,2,18,30,60.0,12,18,8,10,16,48,61,0,Adam MarusicLazio
Las Palmas,Marvin,1659,es ESP,"DF,FW",es La Liga,24,2000,11.5,25,13,12,9,4,11,26,42.3,15,17,6,11,15,40,34,0,MarvinLas Palmas
Mallorca,Omar Mascarell,1660,gq EQG,MF,es La Liga,31,1993,22.1,27,13,13,13,1,14,35,40.0,21,33,21,12,49,76,59,3,Omar MascarellMallorca
Torino,Adam Masina,1661,ma MAR,DF,it Serie A,30,1994,21.3,33,15,22,10,1,23,40,57.5,17,28,15,13,27,60,95,2,Adam MasinaTorino
Genoa,Patrizio Masini,1662,it ITA,MF,it Serie A,23,2001,17.1,54,29,18,26,10,19,40,47.5,21,26,8,18,15,69,37,0,Patrizio MasiniGenoa
Bochum,Giorgos Masouras,1663,gr GRE,"FW,MF",de Bundesliga,30,1994,11.7,18,10,6,7,5,7,16,43.8,9,9,1,8,4,22,3,1,Giorgos MasourasBochum
Bochum,Erhan Masovic,1664,rs SRB,DF,de Bundesliga,25,1998,10.1,14,10,10,4,0,13,28,46.4,15,17,11,6,12,26,55,0,Erhan MasovicBochum
Auxerre,Han-Noah Massengo,1665,fr FRA,MF,fr Ligue 1,23,2001,11.6,17,11,5,8,4,8,12,66.7,4,12,4,8,17,34,10,2,Han-Noah MassengoAuxerre
Lyon,Clinton Mata,1666,ao ANG,DF,fr Ligue 1,31,1992,26.3,41,29,23,14,4,28,36,77.8,8,26,17,9,46,87,72,3,Clinton MataLyon
Las Palmas,Jaime Mata,1667,es ESP,"FW,MF",es La Liga,35,1988,7.3,8,2,2,6,0,3,9,33.3,6,5,1,4,3,11,11,0,Jaime MataLas Palmas
Eint Frankfurt,Igor Matanovic,1668,hr CRO,FW,de Bundesliga,21,2003,3.5,2,0,0,2,0,0,1,0.0,1,3,0,3,1,3,9,0,Igor MatanovicEint Frankfurt
Tottenham,Pape Matar Sarr,1669,sn SEN,MF,eng Premier League,21,2002,21.3,49,36,19,23,7,12,25,48.0,13,26,10,16,30,79,25,1,Pape Matar SarrTottenham
Monaco,Eliot Matazo,1670,be BEL,MF,fr Ligue 1,22,2002,0.8,3,2,0,3,0,0,0,,0,0,0,0,1,4,2,0,Eliot MatazoMonaco
Crystal Palace,Jean-Philippe Mateta,1671,fr FRA,FW,eng Premier League,27,1997,29.4,18,12,5,11,2,3,16,18.8,13,19,4,15,2,20,23,0,Jean-Philippe MatetaCrystal Palace
Lyon,Nemanja Matic,1672,rs SRB,MF,fr Ligue 1,35,1988,22.3,42,29,15,21,6,23,41,56.1,18,21,9,12,18,60,31,1,Nemanja MaticLyon
Auxerre,Rudy Matondo,1673,fr FRA,MF,fr Ligue 1,16,2008,0.7,1,1,1,0,0,0,1,0.0,1,0,0,0,0,1,2,0,Rudy MatondoAuxerre
Augsburg,Chrislain Matsima,1674,fr FRA,DF,de Bundesliga,22,2002,28.3,31,20,19,11,1,17,26,65.4,9,48,29,19,52,83,163,0,Chrislain MatsimaAugsburg
Eint Frankfurt,Jean Matteo Bahoya,1675,fr FRA,"MF,FW",de Bundesliga,19,2005,10.2,29,18,11,13,5,16,26,61.5,10,14,2,12,4,33,10,1,Jean Matteo BahoyaEint Frankfurt
Genoa,Alan Matturro,1676,uy URU,DF,it Serie A,19,2004,10.0,11,6,6,5,0,3,14,21.4,11,10,3,7,14,25,38,0,Alan MatturroGenoa
Rennes,Azor Matusiwa,1677,nl NED,MF,fr Ligue 1,26,1998,23.1,64,39,32,30,2,32,43,74.4,11,29,10,19,34,98,52,0,Azor MatusiwaRennes
Marseille,Neal Maupay,1678,fr FRA,FW,fr Ligue 1,27,1996,11.6,9,4,1,6,2,3,6,50.0,3,5,0,5,2,11,0,0,Neal MaupayMarseille
St. Pauli,Maurides,1679,br BRA,FW,de Bundesliga,30,1994,0.0,0,0,0,0,0,0,0,,0,0,0,0,0,0,0,0,MauridesSt. Pauli
Leicester City,Stephy Mavididi,1680,eng ENG,FW,eng Premier League,26,1998,17.9,34,19,16,10,8,14,42,33.3,28,26,2,24,11,45,15,0,Stephy MavididiLeicester City
West Ham,Konstantinos Mavropanos,1681,gr GRE,DF,eng Premier League,26,1997,22.7,35,24,24,10,1,16,27,59.3,11,25,18,7,40,75,126,1,Konstantinos MavropanosWest Ham
Monaco,Christian Mawissa,1682,fr FRA,DF,fr Ligue 1,19,2005,16.7,42,29,27,13,2,26,44,59.1,18,25,6,19,26,68,48,1,Christian MawissaMonaco
Werder Bremen,Keke Maximilian Topp,1683,de GER,"FW,MF",de Bundesliga,20,2004,2.8,3,1,0,2,1,1,2,50.0,1,0,0,0,1,4,4,0,Keke Maximilian ToppWerder Bremen
Getafe,Borja Mayoral,1684,es ESP,FW,es La Liga,27,1997,12.4,5,4,2,2,1,3,9,33.3,6,4,0,4,2,7,6,0,Borja MayoralGetafe
Paris S-G,Senny Mayulu,1685,fr FRA,MF,fr Ligue 1,18,2006,9.0,25,16,8,14,3,8,14,57.1,6,8,3,5,5,30,12,0,Senny MayuluParis S-G
Manchester Utd,Noussair Mazraoui,1686,ma MAR,DF,eng Premier League,26,1997,31.5,115,68,58,42,15,59,94,62.8,35,36,9,27,34,149,95,1,Noussair MazraouiManchester Utd
Monza,Andrea Mazza,1687,it ITA,GK,it Serie A,20,2004,0.1,0,0,0,0,0,0,0,,0,0,0,0,0,0,0,0,Andrea MazzaMonza
Como,Luca Mazzitelli,1688,it ITA,MF,it Serie A,28,1995,3.7,9,6,4,5,0,5,7,71.4,2,5,2,3,3,12,10,0,Luca MazzitelliComo
Napoli,Pasquale Mazzocchi,1689,it ITA,"DF,FW",it Serie A,29,1995,7.8,15,7,7,5,3,8,15,53.3,7,5,2,3,5,20,25,0,Pasquale MazzocchiNapoli
Juventus,Samuel Mbangula,1690,be BEL,FW,it Serie A,20,2004,7.9,15,10,7,6,2,7,13,53.8,6,7,0,7,3,18,4,0,Samuel MbangulaJuventus
Lille,Ethan Mbappe,1691,fr FRA,"MF,FW",fr Ligue 1,17,2006,2.5,6,2,3,2,1,0,4,0.0,4,6,0,6,1,7,0,0,Ethan MbappeLille
Real Madrid,Kylian Mbappe,1692,fr FRA,FW,es La Liga,25,1998,32.3,8,5,1,3,4,1,5,20.0,4,3,0,3,1,9,1,1,Kylian MbappeReal Madrid
Paris S-G,Ibrahim Mbaye,1693,fr FRA,"FW,MF",fr Ligue 1,16,2008,3.8,4,2,1,2,1,3,8,37.5,5,2,0,2,2,6,2,0,Ibrahim MbayeParis S-G
Brentford,Bryan Mbeumo,1694,cm CMR,FW,eng Premier League,24,1999,37.9,49,31,18,15,16,21,35,60.0,14,26,3,23,14,63,55,1,Bryan MbeumoBrentford
Manchester City,James Mcatee,1695,eng ENG,"MF,FW",eng Premier League,21,2002,3.9,5,2,0,4,1,1,7,14.3,6,8,0,8,2,7,1,0,James McateeManchester City
Leicester City,Kasey McAteer,1696,ie IRL,FW,eng Premier League,22,2001,9.5,23,16,11,9,3,14,29,48.3,15,18,2,16,5,28,15,0,Kasey McAteerLeicester City
Las Palmas,Oliver McBurnie,1697,sct SCO,FW,es La Liga,28,1996,20.4,15,7,5,8,2,5,12,41.7,7,15,5,10,6,21,24,0,Oliver McBurnieLas Palmas
Southampton,Alex McCarthy,1698,eng ENG,GK,eng Premier League,34,1989,5.0,0,0,0,0,0,0,0,,0,0,0,0,0,0,1,4,Alex McCarthySouthampton
Aston Villa,John McGinn,1699,sct SCO,"MF,FW",eng Premier League,29,1994,24.7,33,24,10,14,9,13,31,41.9,18,22,2,20,14,47,18,3,John McGinnAston Villa
Las Palmas,Scott McKenna,1700,sct SCO,DF,es La Liga,27,1996,27.4,21,13,16,5,0,9,12,75.0,3,36,28,8,9,30,163,2,Scott McKennaLas Palmas
Juventus,Weston McKennie,1701,us USA,"MF,DF",it Serie A,25,1998,25.7,33,12,18,11,4,13,22,59.1,9,28,8,20,14,47,37,0,Weston McKennieJuventus
Toulouse,Mark McKenzie,1702,us USA,DF,fr Ligue 1,25,1999,27.7,52,31,31,20,1,33,45,73.3,12,31,18,13,22,74,141,1,Mark McKenzieToulouse
Everton,Dwight McNeil,1703,eng ENG,"MF,FW",eng Premier League,24,1999,15.2,13,8,6,5,2,9,21,42.9,12,7,0,7,6,19,2,1,Dwight McNeilEverton
Manchester Utd,Scott McTominay,1704,sct SCO,MF,eng Premier League,27,1996,0.2,0,0,0,0,0,0,1,0.0,1,0,0,0,0,0,1,0,Scott McTominayManchester Utd
Napoli,Scott McTominay,1705,sct SCO,MF,it Serie A,27,1996,32.6,43,25,12,27,4,18,36,50.0,18,22,5,17,24,67,51,0,Scott McTominayNapoli
Bochum,Jakov Medic,1706,hr CRO,DF,de Bundesliga,25,1998,17.8,13,11,9,3,1,8,18,44.4,10,32,21,11,22,35,111,4,Jakov MedicBochum
Lens,Facundo Medina,1707,ar ARG,DF,fr Ligue 1,25,1999,28.3,44,29,22,18,4,24,42,57.1,18,30,10,20,32,76,70,0,Facundo MedinaLens
Brentford,Ben Mee,1708,eng ENG,DF,eng Premier League,34,1989,2.0,2,2,0,2,0,1,1,100.0,0,3,3,0,4,6,7,0,Ben MeeBrentford
Brentford,Jayden Meghoma,1709,eng ENG,DF,eng Premier League,18,2006,0.1,0,0,0,0,0,0,0,,0,0,0,0,0,0,0,0,Jayden MeghomaBrentford
Rennes,Henrik Meister,1710,dk DEN,FW,fr Ligue 1,20,2003,0.7,2,0,0,2,0,0,0,,0,4,0,4,1,3,0,0,Henrik MeisterRennes
Montpellier,Bamo Meite,1711,ci CIV,DF,fr Ligue 1,22,2001,4.7,5,3,2,1,2,1,2,50.0,1,3,3,0,4,9,14,3,Bamo MeiteMontpellier
Marseille,Bamo Meite,1712,ci CIV,DF,fr Ligue 1,22,2001,0.3,0,0,0,0,0,0,0,,0,0,0,0,0,0,1,0,Bamo MeiteMarseille
Rennes,Mohamed Meite,1713,fr FRA,FW,fr Ligue 1,16,2007,6.0,2,0,0,2,0,1,1,100.0,0,1,0,1,0,2,5,0,Mohamed MeiteRennes
Sevilla,Mateo Mejia,1714,es ESP,FW,es La Liga,21,2003,0.1,0,0,0,0,0,0,0,,0,0,0,0,0,0,0,0,Mateo MejiaSevilla
Angers,Farid El Melali,1715,dz ALG,FW,fr Ligue 1,27,1997,21.0,28,16,15,6,7,13,35,37.1,22,19,1,18,16,44,12,1,Farid El MelaliAngers
Genoa,Filippo Melegoni,1716,it ITA,"MF,FW",it Serie A,25,1999,1.0,1,1,1,0,0,0,4,0.0,4,0,0,0,0,1,2,0,Filippo MelegoniGenoa
Girona,Arthur Melo,1717,br BRA,MF,es La Liga,27,1996,10.5,25,11,8,12,5,14,27,51.9,13,5,1,4,8,33,12,1,Arthur MeloGirona
Paris S-G,Nuno Mendes,1718,pt POR,DF,fr Ligue 1,22,2002,18.6,30,19,15,12,3,23,39,59.0,16,25,8,17,18,48,37,2,Nuno MendesParis S-G
Real Sociedad,Brais Mendez,1719,es ESP,MF,es La Liga,27,1997,17.0,24,13,6,14,4,9,24,37.5,15,14,1,13,7,31,16,1,Brais MendezReal Sociedad
Nice,Antoine Mendy,1720,sn SEN,DF,fr Ligue 1,20,2004,9.2,30,21,16,14,0,19,29,65.5,10,9,5,4,8,38,29,1,Antoine MendyNice
Real Madrid,Ferland Mendy,1721,fr FRA,DF,es La Liga,29,1995,11.2,17,14,7,6,4,9,12,75.0,3,11,4,7,9,26,8,1,Ferland MendyReal Madrid
Lens,Nampalys Mendy,1722,sn SEN,MF,fr Ligue 1,32,1992,6.5,15,8,4,7,4,6,14,42.9,8,8,2,6,9,24,8,0,Nampalys MendyLens
Betis,Nobel Mendy,1723,fr FRA,DF,es La Liga,19,2004,1.2,0,0,0,0,0,0,0,,0,2,0,2,4,4,10,1,Nobel MendyBetis
Auxerre,Gideon Mensah,1724,gh GHA,DF,fr Ligue 1,26,1998,25.3,68,45,37,21,10,33,66,50.0,33,27,4,23,50,118,83,0,Gideon MensahAuxerre
Napoli,Alex Meret,1725,it ITA,GK,it Serie A,27,1997,33.4,0,0,0,0,0,0,0,,0,1,0,1,0,0,16,0,Alex MeretNapoli
Arsenal,Mikel Merino,1726,es ESP,"MF,FW",eng Premier League,28,1996,17.6,46,28,7,26,13,20,36,55.6,16,18,5,13,15,61,26,2,Mikel MerinoArsenal
Marseille,Quentin Merlin,1727,fr FRA,DF,fr Ligue 1,22,2002,17.7,22,17,12,5,5,9,16,56.3,7,20,4,16,14,36,17,1,Quentin MerlinMarseille
Valladolid,Victor Meseguer,1728,es ESP,MF,es La Liga,25,1999,4.6,10,6,4,4,2,2,10,20.0,8,3,0,3,2,12,4,1,Victor MeseguerValladolid
Toulouse,Rafik Messali,1729,fr FRA,DF,fr Ligue 1,21,2003,5.1,15,8,6,6,3,7,8,87.5,1,9,1,8,10,25,12,0,Rafik MessaliToulouse
Genoa,Junior Messias,1730,br BRA,"MF,FW",it Serie A,33,1991,9.4,13,7,6,6,1,3,10,30.0,7,8,2,6,6,19,20,0,Junior MessiasGenoa
St. Pauli,Connor Metcalfe,1731,au AUS,"MF,FW",de Bundesliga,24,1999,4.0,2,0,1,1,0,0,5,0.0,5,4,0,4,3,5,8,0,Connor MetcalfeSt. Pauli
St. Pauli,Karol Mets,1732,ee EST,DF,de Bundesliga,31,1993,10.0,13,8,6,7,0,4,7,57.1,3,9,3,6,12,25,60,0,Karol MetsSt. Pauli
Lille,Thomas Meunier,1733,be BEL,DF,fr Ligue 1,32,1991,21.4,53,38,32,15,6,33,49,67.3,16,21,8,13,34,87,64,0,Thomas MeunierLille
Dortmund,Alexander Meyer,1734,de GER,GK,de Bundesliga,33,1991,2.0,0,0,0,0,0,0,0,,0,0,0,0,0,0,0,0,Alexander MeyerDortmund
Chelsea,Shumaira Mheuka,1735,eng ENG,MF,eng Premier League,16,2007,0.0,0,0,0,0,0,0,0,,0,0,0,0,0,0,0,0,Shumaira MheukaChelsea
Monaco,Lucas Michal,1736,fr FRA,"FW,MF",fr Ligue 1,19,2005,1.3,5,3,3,2,0,2,4,50.0,2,2,0,2,1,6,2,0,Lucas MichalMonaco
Hoffenheim,Florian Micheler,1737,at AUT,MF,de Bundesliga,19,2005,0.4,0,0,0,0,0,0,2,0.0,2,0,0,0,0,0,0,0,Florian MichelerHoffenheim
Leganes,Miguel,1738,es ESP,FW,es La Liga,24,1999,19.2,16,7,6,4,6,4,14,28.6,10,15,4,11,4,20,23,1,MiguelLeganes
Parma,Valentin Mihaila,1739,ro ROU,"FW,MF",it Serie A,24,2000,14.3,29,15,8,13,8,9,22,40.9,13,18,0,18,8,37,6,0,Valentin MihailaParma
Lyon,Georges Mikautadze,1740,ge GEO,FW,fr Ligue 1,23,2000,16.1,7,6,1,3,3,3,9,33.3,6,11,0,11,4,11,6,0,Georges MikautadzeLyon
Saint-Etienne,Igor Miladinovic,1741,rs SRB,"FW,MF",fr Ligue 1,21,2003,0.3,0,0,0,0,0,0,0,,0,0,0,0,1,1,1,0,Igor MiladinovicSaint-Etienne
Nott'ham Forest,Nikola Milenkovic,1742,rs SRB,DF,eng Premier League,26,1997,37.0,51,29,36,13,2,27,34,79.4,7,41,24,17,27,78,209,1,Nikola MilenkovicNott'ham Forest
Newcastle Utd,Lewis Miley,1743,eng ENG,MF,eng Premier League,18,2006,3.5,14,11,5,7,2,7,14,50.0,7,5,1,4,2,16,5,2,Lewis MileyNewcastle Utd
Torino,Vanja Milinkovic-Savic,1744,rs SRB,GK,it Serie A,27,1997,37.0,1,0,1,0,0,1,3,33.3,2,0,0,0,0,1,18,4,Vanja Milinkovic-SavicTorino
Real Madrid,Eder Militao,1745,br BRA,DF,es La Liga,26,1998,10.4,19,17,14,5,0,7,12,58.3,5,13,8,5,12,31,35,0,Eder MilitaoReal Madrid
Getafe,Luis Milla,1746,es ESP,MF,es La Liga,29,1994,31.9,61,40,28,25,8,35,72,48.6,37,25,0,25,24,85,28,3,Luis MillaGetafe
Espanyol,Pere Milla,1747,es ESP,"MF,FW",es La Liga,31,1992,5.1,6,2,5,0,1,1,18,5.6,17,10,2,8,3,9,5,0,Pere MillaEspanyol
Stuttgart,Enzo Millot,1748,fr FRA,"MF,FW",de Bundesliga,22,2002,20.5,30,13,10,15,5,12,35,34.3,23,27,0,27,13,43,6,1,Enzo MillotStuttgart
Brighton,James Milner,1749,eng ENG,MF,eng Premier League,38,1986,1.9,5,2,1,3,1,3,3,100.0,0,4,2,2,2,7,2,1,James MilnerBrighton
Bayern Munich,Kim Min-jae,1750,kr KOR,DF,de Bundesliga,27,1996,25.4,35,20,18,13,4,11,21,52.4,10,23,10,13,37,72,91,4,Kim Min-jaeBayern Munich
Cagliari,Yerry Mina,1751,co COL,DF,it Serie A,29,1994,28.5,66,32,43,21,2,40,52,76.9,12,59,35,24,37,103,163,3,Yerry MinaCagliari
Monaco,Takumi Minamino,1752,jp JPN,"MF,FW",fr Ligue 1,29,1995,24.8,33,19,7,14,12,15,42,35.7,27,26,1,25,10,43,20,0,Takumi MinaminoMonaco
Montpellier,Lucas Mincarelli,1753,fr FRA,DF,fr Ligue 1,20,2004,7.9,17,10,6,9,2,6,13,46.2,7,8,5,3,9,26,27,0,Lucas MincarelliMontpellier
Aston Villa,Tyrone Mings,1754,eng ENG,DF,eng Premier League,31,1993,12.4,7,6,6,1,0,2,2,100.0,0,13,11,2,7,14,61,1,Tyrone MingsAston Villa
Celta Vigo,Oscar Mingueza,1755,es ESP,"MF,DF",es La Liga,25,1999,30.3,38,24,21,12,5,26,69,37.7,43,35,5,30,22,60,46,7,Oscar MinguezaCelta Vigo
Girona,Kim Minsu,1756,kr KOR,"MF,FW",es La Liga,18,2006,0.2,1,0,0,1,0,0,0,,0,0,0,0,0,1,0,0,Kim MinsuGirona
Brighton,Yankuba Minteh,1757,gm GAM,"FW,MF",eng Premier League,20,2004,20.4,48,35,25,13,10,17,45,37.8,28,22,0,22,11,59,31,0,Yankuba MintehBrighton
Girona,Bojan Miovski,1758,mk MKD,FW,es La Liga,25,1999,9.7,7,5,2,2,3,2,7,28.6,5,4,0,4,2,9,7,0,Bojan MiovskiGirona
Valencia,Rafa Mir,1759,es ESP,"FW,MF",es La Liga,27,1997,8.4,12,6,8,4,0,3,9,33.3,6,5,0,5,5,17,9,0,Rafa MirValencia
Bologna,Juan Miranda,1760,es ESP,DF,it Serie A,24,2000,25.3,32,18,11,14,7,14,33,42.4,19,21,3,18,23,55,50,1,Juan MirandaBologna
Genoa,Fabio Miretti,1761,it ITA,"MF,FW",it Serie A,20,2003,18.6,28,15,6,14,8,18,33,54.5,15,20,1,19,7,35,13,2,Fabio MirettiGenoa
Crystal Palace,Tyrick Mitchell,1762,eng ENG,DF,eng Premier League,24,1999,34.4,91,55,57,27,7,25,46,54.3,21,68,12,56,19,110,108,2,Tyrick MitchellCrystal Palace
Brighton,Kaoru Mitoma,1763,jp JPN,"FW,MF",eng Premier League,27,1997,28.9,45,27,15,14,16,19,49,38.8,30,48,3,45,14,59,10,0,Kaoru MitomaBrighton
Stuttgart,Maximilian Mittelstadt,1764,de GER,DF,de Bundesliga,27,1997,27.4,79,54,42,30,7,53,73,72.6,20,47,11,36,47,126,96,2,Maximilian MittelstadtStuttgart
Bochum,Koji Miyoshi,1765,jp JPN,"FW,MF",de Bundesliga,27,1997,5.2,8,5,2,1,5,4,9,44.4,5,10,1,9,2,10,2,0,Koji MiyoshiBochum
Inter,Henrikh Mkhitaryan,1766,am ARM,MF,it Serie A,35,1989,25.9,43,24,17,16,10,20,45,44.4,25,29,5,24,16,59,41,0,Henrikh MkhitaryanInter
Brighton,Jakub Moder,1767,pl POL,MF,eng Premier League,25,1999,0.1,1,0,1,0,0,0,2,0.0,2,0,0,0,0,1,3,0,Jakub ModerBrighton
Udinese,Rui Modesto,1768,ao ANG,"DF,MF",it Serie A,24,1999,6.8,16,12,4,9,3,7,9,77.8,2,10,0,10,8,24,13,0,Rui ModestoUdinese
Real Madrid,Luka Modric,1769,hr CRO,MF,es La Liga,38,1985,20.3,31,20,16,13,2,14,32,43.8,18,17,5,12,27,58,17,0,Luka ModricReal Madrid
Hoffenheim,Max Moerstedt,1770,de GER,FW,de Bundesliga,,,5.0,5,5,1,3,1,1,2,50.0,1,4,0,4,0,5,5,0,Max MoerstedtHoffenheim
Nice,Terem Moffi,1771,ng NGA,FW,fr Ligue 1,25,1999,0.6,0,0,0,0,0,0,0,,0,0,0,0,0,0,0,0,Terem MoffiNice
Nantes,Mostafa Mohamed,1772,eg EGY,FW,fr Ligue 1,26,1997,13.9,18,9,6,8,4,4,12,33.3,8,10,2,8,10,28,27,0,Mostafa MohamedNantes
Mallorca,Johan Mojica,1773,co COL,DF,es La Liga,31,1992,30.6,35,23,26,6,3,19,40,47.5,21,13,5,8,26,61,84,3,Johan MojicaMallorca
Hoffenheim,David Mokwa,1774,fr FRA,"DF,FW",de Bundesliga,20,2004,0.2,1,0,1,0,0,0,0,,0,0,0,0,0,1,0,0,David MokwaHoffenheim
Las Palmas,Alberto Moleiro,1775,es ESP,"FW,MF",es La Liga,20,2003,30.2,27,12,12,14,1,18,48,37.5,30,24,0,24,18,45,8,0,Alberto MoleiroLas Palmas
Atletico Madrid,Nahuel Molina,1776,ar ARG,DF,es La Liga,26,1998,17.7,44,19,21,21,2,31,56,55.4,25,16,3,13,13,57,53,0,Nahuel MolinaAtletico Madrid
Nantes,Florent Mollet,1777,fr FRA,"MF,FW",fr Ligue 1,32,1991,2.7,2,2,1,1,0,1,1,100.0,0,2,0,2,1,3,4,0,Florent MolletNantes
Osasuna,Jon Moncayola,1778,es ESP,MF,es La Liga,26,1998,23.3,70,41,29,33,8,31,60,51.7,29,34,3,31,11,81,20,0,Jon MoncayolaOsasuna
Leicester City,Jeremy Monga,1779,,"FW,MF",eng Premier League,,,1.2,2,1,0,1,1,1,1,100.0,0,3,2,1,0,2,1,0,Jeremy MongaLeicester City
Sevilla,Gonzalo Montiel,1780,ar ARG,"DF,MF",es La Liga,27,1997,1.3,4,2,3,1,0,3,4,75.0,1,0,0,0,2,6,11,0,Gonzalo MontielSevilla
Hellas Verona,Lorenzo Montipo,1781,it ITA,GK,it Serie A,28,1996,36.0,1,0,1,0,0,1,4,25.0,3,0,0,0,0,1,24,4,Lorenzo MontipoHellas Verona
Tottenham,Mikey Moore,1782,eng ENG,FW,eng Premier League,16,2007,4.1,2,1,2,0,0,0,4,0.0,4,2,0,2,1,3,4,0,Mikey MooreTottenham
Milan,Alvaro Morata,1783,es ESP,"FW,MF",it Serie A,31,1992,12.2,16,10,5,8,3,5,8,62.5,3,7,2,5,5,21,5,0,Alvaro MorataMilan
Nott'ham Forest,Morato,1784,br BRA,DF,eng Premier League,23,2001,10.1,22,14,18,3,1,13,21,61.9,8,14,5,9,10,32,78,2,MoratoNott'ham Forest
Strasbourg,Diego Moreira,1785,pt POR,"DF,MF",fr Ligue 1,19,2004,28.5,44,28,17,19,8,24,50,48.0,26,23,4,19,35,79,65,0,Diego MoreiraStrasbourg
Como,Alberto Moreno,1786,es ESP,DF,it Serie A,32,1992,19.2,25,11,17,8,0,12,26,46.2,14,12,3,9,14,39,40,2,Alberto MorenoComo
Nott'ham Forest,Alex Moreno,1787,es ESP,"DF,MF",eng Premier League,31,1993,10.6,25,18,20,5,0,15,39,38.5,24,11,5,6,15,40,43,0,Alex MorenoNott'ham Forest
Villarreal,Gerard Moreno,1788,es ESP,FW,es La Liga,32,1992,8.0,7,4,3,2,2,3,12,25.0,9,0,0,0,2,9,8,0,Gerard MorenoVillarreal
Fiorentina,Matias Moreno,1789,ar ARG,DF,it Serie A,20,2003,1.6,8,8,5,3,0,4,4,100.0,0,5,1,4,1,9,9,0,Matias MorenoFiorentina
Valladolid,Xavier Moreno,1790,es ESP,FW,es La Liga,19,2004,0.5,0,0,0,0,0,0,0,,0,0,0,0,0,0,1,0,Xavier MorenoValladolid
Lecce,Tete Morente,1791,es ESP,"FW,MF",it Serie A,27,1996,22.5,27,17,10,11,6,10,36,27.8,26,16,1,15,14,41,31,1,Tete MorenteLecce
Mallorca,Mateu Morey,1792,es ESP,DF,es La Liga,24,2000,8.2,22,18,13,6,3,12,22,54.5,10,11,0,11,15,37,32,2,Mateu MoreyMallorca
Celta Vigo,Ilaix Moriba,1793,gn GUI,MF,es La Liga,21,2003,23.7,68,42,24,30,14,32,57,56.1,25,29,4,25,14,82,33,1,Ilaix MoribaCelta Vigo
Mallorca,Manu Morlanes,1794,es ESP,MF,es La Liga,25,1999,14.9,43,27,18,20,5,18,30,60.0,12,19,8,11,24,67,16,0,Manu MorlanesMallorca
Bologna,Nikola Moro,1795,hr CRO,MF,it Serie A,26,1998,13.4,35,27,7,21,7,22,33,66.7,11,18,7,11,13,48,18,0,Nikola MoroBologna
Valladolid,Raul Moro,1796,es ESP,"MF,FW",es La Liga,21,2002,26.0,22,13,15,4,3,13,32,40.6,19,8,0,8,10,32,20,1,Raul MoroValladolid
Ipswich Town,Sam Morsy,1797,eg EGY,MF,eng Premier League,32,1991,30.6,68,41,40,24,4,27,62,43.5,35,34,13,21,29,97,47,5,Sam MorsyIpswich Town
Reims,Gabriel Moscardo,1798,br BRA,"MF,DF",fr Ligue 1,18,2005,0.9,3,1,2,1,0,1,3,33.3,2,3,1,2,0,3,1,0,Gabriel MoscardoReims
Valencia,Cristhian Mosquera,1799,es ESP,DF,es La Liga,20,2004,36.9,56,36,41,13,2,31,40,77.5,9,37,24,13,35,91,128,4,Cristhian MosqueraValencia
Hellas Verona,Daniel Mosquera,1800,co COL,FW,it Serie A,24,1999,15.3,11,8,3,5,3,1,15,6.7,14,11,1,10,2,13,10,0,Daniel MosqueraHellas Verona
Wolves,Yerson Mosquera,1801,co COL,DF,eng Premier League,23,2001,4.9,11,7,9,2,0,9,14,64.3,5,13,10,3,10,21,14,0,Yerson MosqueraWolves
Monza,Dany Mota,1802,pt POR,"FW,MF",it Serie A,26,1998,23.4,13,3,2,3,8,4,8,50.0,4,18,1,17,9,22,27,3,Dany MotaMonza
Montpellier,Yael Mouanga,1803,fr FRA,DF,fr Ligue 1,19,2005,10.5,14,8,9,3,2,7,9,77.8,2,16,8,8,10,24,50,0,Yael MouangaMontpellier
Saint-Etienne,Aimen Moueffek,1804,fr FRA,MF,fr Ligue 1,23,2001,11.5,20,12,3,11,6,10,23,43.5,13,20,7,13,5,25,26,1,Aimen MoueffekSaint-Etienne
Nice,Youssoufa Moukoko,1805,de GER,"FW,MF",fr Ligue 1,19,2004,2.3,3,2,2,1,0,1,2,50.0,1,2,0,2,0,3,0,0,Youssoufa MoukokoNice
Augsburg,Steve Mounie,1806,bj BEN,"FW,MF",de Bundesliga,29,1994,3.9,4,4,0,1,3,0,1,0.0,1,1,1,0,1,5,5,1,Steve MounieAugsburg
Manchester Utd,Mason Mount,1807,eng ENG,MF,eng Premier League,25,1999,6.9,15,5,5,8,2,9,12,75.0,3,11,1,10,4,19,4,0,Mason MountManchester Utd
Alaves,Santiago Mourino,1808,uy URU,DF,es La Liga,22,2002,20.5,43,28,31,12,0,21,38,55.3,17,27,12,15,29,72,120,0,Santiago MourinoAlaves
Saint-Etienne,Louis Mouton,1809,fr FRA,MF,fr Ligue 1,22,2002,11.6,49,25,14,25,10,22,37,59.5,15,17,3,14,10,59,19,0,Louis MoutonSaint-Etienne
Manchester City,Divin Mubama,1810,eng ENG,FW,eng Premier League,19,2004,0.3,0,0,0,0,0,0,0,,0,0,0,0,0,0,0,0,Divin MubamaManchester City
Chelsea,Mykhailo Mudryk,1811,ua UKR,FW,eng Premier League,23,2001,1.7,2,2,2,0,0,0,0,,0,3,1,2,0,2,1,0,Mykhailo MudrykChelsea
Lille,Ngal'Ayel Mukau,1812,cd COD,MF,fr Ligue 1,19,2004,13.2,33,18,9,22,2,17,29,58.6,12,14,0,14,15,48,22,0,Ngal'Ayel MukauLille
Leverkusen,Nordi Mukiele,1813,fr FRA,DF,de Bundesliga,26,1997,10.0,20,16,8,8,4,12,18,66.7,6,10,0,10,16,36,37,2,Nordi MukieleLeverkusen
Freiburg,Florian Muller,1814,de GER,GK,de Bundesliga,26,1997,8.4,0,0,0,0,0,0,0,,0,0,0,0,0,0,3,0,Florian MullerFreiburg
Heidenheim,Kevin Muller,1815,de GER,GK,de Bundesliga,33,1991,32.7,3,2,3,0,0,3,3,100.0,0,0,0,0,0,3,13,4,Kevin MullerHeidenheim
Wolfsburg,Marius Muller,1816,de GER,GK,de Bundesliga,31,1993,5.3,0,0,0,0,0,0,0,,0,0,0,0,0,0,0,0,Marius MullerWolfsburg
Bayern Munich,Thomas Muller,1817,de GER,"MF,FW",de Bundesliga,34,1989,13.6,8,5,2,3,3,4,16,25.0,12,10,0,10,2,10,14,0,Thomas MullerBayern Munich
Rayo Vallecano,Abdul Mumin,1818,gh GHA,DF,es La Liga,26,1998,22.4,37,25,30,7,0,17,27,63.0,10,40,29,11,23,60,125,0,Abdul MuminRayo Vallecano
Wolves,Marshall Munetsi,1819,zw ZIM,"MF,FW",eng Premier League,28,1996,12.0,24,10,7,11,6,13,23,56.5,10,14,1,13,6,30,18,0,Marshall MunetsiWolves
Reims,Marshall Munetsi,1820,zw ZIM,MF,fr Ligue 1,28,1996,18.8,36,18,22,9,5,22,38,57.9,16,27,3,24,17,53,35,0,Marshall MunetsiReims
Fulham,Rodrigo Muniz,1821,br BRA,FW,eng Premier League,23,2001,10.7,10,5,3,5,2,4,4,100.0,0,9,2,7,5,15,14,0,Rodrigo MunizFulham
Real Sociedad,Aihen Munoz,1822,es ESP,DF,es La Liga,26,1997,12.2,24,12,14,8,2,14,28,50.0,14,11,6,5,14,38,47,0,Aihen MunozReal Sociedad
Las Palmas,Alex Munoz,1823,es ESP,DF,es La Liga,30,1994,15.7,39,29,22,16,1,21,38,55.3,17,28,11,17,16,55,69,0,Alex MunozLas Palmas
Crystal Palace,Daniel Munoz,1824,co COL,DF,eng Premier League,28,1996,35.9,123,80,57,41,25,55,97,56.7,42,40,6,34,44,167,108,1,Daniel MunozCrystal Palace
Osasuna,Iker Munoz,1825,es ESP,MF,es La Liga,21,2002,6.8,5,2,3,2,0,3,9,33.3,6,9,2,7,4,9,12,1,Iker MunozOsasuna
Las Palmas,Javier Munoz,1826,es ESP,"MF,DF",es La Liga,29,1995,28.8,45,35,18,17,10,16,46,34.8,30,27,4,23,31,76,39,3,Javier MunozLas Palmas
Real Madrid,Victor Munoz,1827,es ESP,"FW,DF",es La Liga,21,2003,0.4,0,0,0,0,0,0,0,,0,0,0,0,0,0,0,0,Victor MunozReal Madrid
Ipswich Town,Arijanet Muric,1828,xk KVX,GK,eng Premier League,25,1998,18.0,0,0,0,0,0,0,2,0.0,2,0,0,0,0,0,10,5,Arijanet MuricIpswich Town
Nott'ham Forest,Murillo,1829,br BRA,DF,eng Premier League,22,2002,35.4,53,36,38,12,3,27,46,58.7,19,69,45,24,36,89,249,3,MurilloNott'ham Forest
Mallorca,Vedat Muriqi,1830,xk KVX,FW,es La Liga,30,1994,22.9,7,5,3,2,2,3,7,42.9,4,7,1,6,7,14,43,0,Vedat MuriqiMallorca
Newcastle Utd,Jacob Murphy,1831,eng ENG,FW,eng Premier League,29,1995,26.2,28,19,10,12,6,20,44,45.5,24,31,0,31,13,41,35,1,Jacob MurphyNewcastle Utd
Milan,Bob Murphy Omoregbe,1832,it ITA,MF,it Serie A,20,2003,0.0,0,0,0,0,0,0,0,,0,0,0,0,0,0,0,0,Bob Murphy OmoregbeMilan
Milan,Yunus Musah,1833,us USA,"MF,FW",it Serie A,21,2002,17.5,27,19,13,9,5,12,17,70.6,5,9,1,8,7,34,9,3,Yunus MusahMilan
Bayern Munich,Jamal Musiala,1834,de GER,MF,de Bundesliga,21,2003,20.0,36,21,7,16,13,12,29,41.4,17,30,0,30,8,44,5,1,Jamal MusialaBayern Munich
Freiburg,Florent Muslija,1835,xk KVX,"FW,MF",de Bundesliga,26,1998,1.9,5,4,3,1,1,2,2,100.0,0,0,0,0,1,6,1,0,Florent MuslijaFreiburg
Monaco,Almoatasem Al Musrati,1836,ly LBY,MF,fr Ligue 1,28,1996,4.3,14,11,5,8,1,7,11,63.6,4,3,1,2,5,19,9,0,Almoatasem Al MusratiMonaco
Atalanta,Juan Musso,1837,ar ARG,GK,it Serie A,30,1994,1.0,0,0,0,0,0,0,0,,0,0,0,0,0,0,0,0,Juan MussoAtalanta
Atletico Madrid,Juan Musso,1838,ar ARG,GK,es La Liga,30,1994,2.0,0,0,0,0,0,0,0,,0,0,0,0,0,0,0,0,Juan MussoAtletico Madrid
Cagliari,Kingstone Mutandwa,1839,zm ZAM,"FW,MF",it Serie A,21,2003,1.4,0,0,0,0,0,0,0,,0,0,0,0,0,0,0,0,Kingstone MutandwaCagliari
Le Havre,Junior Mwanga,1840,fr FRA,MF,fr Ligue 1,21,2003,10.6,26,16,10,13,3,11,19,57.9,8,10,3,7,8,34,18,2,Junior MwangaLe Havre
Strasbourg,Junior Mwanga,1841,fr FRA,MF,fr Ligue 1,21,2003,3.3,17,9,9,7,1,5,9,55.6,4,2,0,2,2,19,2,0,Junior MwangaStrasbourg
Mainz 05,Phillipp Mwene,1842,at AUT,DF,de Bundesliga,30,1994,29.0,51,29,23,22,6,19,46,41.3,27,27,6,21,24,75,51,1,Phillipp MweneMainz 05
Everton,Vitaliy Mykolenko,1843,ua UKR,DF,eng Premier League,25,1999,34.2,63,38,39,14,10,29,56,51.8,27,25,10,15,44,107,145,2,Vitaliy MykolenkoEverton
Wolfsburg,Joakim Maehle,1844,dk DEN,DF,de Bundesliga,27,1997,24.3,34,15,26,6,2,17,45,37.8,28,24,3,21,25,59,57,2,Joakim MaehleWolfsburg
Roma,Obite N'Dicka,1845,ci CIV,DF,it Serie A,24,1999,38.0,32,26,17,15,0,14,21,66.7,7,46,30,16,33,65,150,2,Obite N'DickaRoma
Lecce,Konan N'dri,1846,ci CIV,"FW,MF",it Serie A,23,2000,3.4,3,3,0,0,3,2,3,66.7,1,4,0,4,1,4,0,0,Konan N'driLecce
Auxerre,Loic N'Gatta,1847,fr FRA,DF,fr Ligue 1,20,2003,0.1,1,1,0,1,0,1,2,50.0,1,1,0,1,0,1,1,0,Loic N'GattaAuxerre
Gladbach,Nathan N'Goumou,1848,cm CMR,FW,de Bundesliga,24,2000,9.2,17,11,11,4,2,6,11,54.5,5,8,2,6,4,21,16,0,Nathan N'GoumouGladbach
Saint-Etienne,Djylian N'Guessan,1849,fr FRA,FW,fr Ligue 1,15,2008,2.0,6,4,5,1,0,2,5,40.0,3,1,0,1,0,6,1,0,Djylian N'GuessanSaint-Etienne
Hoffenheim,Stanley N'Soki,1850,fr FRA,DF,de Bundesliga,25,1999,14.5,22,16,13,7,2,12,23,52.2,11,22,7,15,26,48,58,3,Stanley N'SokiHoffenheim
Saint-Etienne,Mickael Nade,1851,fr FRA,DF,fr Ligue 1,25,1999,25.6,59,43,40,19,0,28,36,77.8,8,37,19,18,33,92,132,8,Mickael NadeSaint-Etienne
Marseille,Bilal Nadir,1852,ma MAR,MF,fr Ligue 1,20,2003,4.3,10,3,4,6,0,4,6,66.7,2,6,1,5,4,14,7,0,Bilal NadirMarseille
Rennes,Mahamadou Nagida,1853,cm CMR,DF,fr Ligue 1,19,2005,4.8,8,6,4,3,1,4,5,80.0,1,3,0,3,9,17,6,0,Mahamadou NagidaRennes
Reims,Keito Nakamura,1854,jp JPN,"FW,MF",fr Ligue 1,24,2000,29.4,24,16,7,10,7,11,31,35.5,20,21,1,20,13,37,19,0,Keito NakamuraReims
Strasbourg,Sebastian Nanasi,1855,se SWE,"MF,FW",fr Ligue 1,22,2002,23.4,20,13,6,12,2,8,22,36.4,14,24,3,21,7,27,18,0,Sebastian NanasiStrasbourg
Nice,Yael Nandjou,1856,fr FRA,DF,fr Ligue 1,19,2005,1.7,4,1,2,1,1,4,8,50.0,4,4,1,3,4,8,7,0,Yael NandjouNice
Stuttgart,Nikolas Nartey,1857,dk DEN,MF,de Bundesliga,24,2000,0.2,0,0,0,0,0,0,0,,0,0,0,0,0,0,4,0,Nikolas NarteyStuttgart
Leganes,Matija Nastasic,1858,rs SRB,DF,es La Liga,31,1993,23.4,25,11,21,4,0,17,25,68.0,8,39,30,9,21,46,165,0,Matija NastasicLeganes
Betis,Natan,1859,br BRA,DF,es La Liga,23,2001,24.2,35,24,24,9,2,26,30,86.7,4,24,14,10,28,63,123,2,NatanBetis
Villarreal,Pau Navarro,1860,es ESP,DF,es La Liga,19,2005,10.2,23,17,15,6,2,19,39,48.7,20,13,6,7,4,27,41,0,Pau NavarroVillarreal
Mallorca,Roberto Navarro,1861,es ESP,"MF,FW",es La Liga,22,2002,14.2,29,22,14,11,4,9,19,47.4,10,18,0,18,19,48,12,0,Roberto NavarroMallorca
Sevilla,Jesus Navas,1862,es ESP,"FW,MF",es La Liga,38,1985,4.7,5,2,3,0,2,0,3,0.0,3,1,0,1,4,9,6,0,Jesus NavasSevilla
Cagliari,Michel Ndary Adopo,1863,fr FRA,MF,it Serie A,24,2000,26.8,55,32,16,31,8,15,29,51.7,14,20,5,15,27,82,25,0,Michel Ndary AdopoCagliari
Nice,Youssouf Ndayishimiye,1864,bi BDI,DF,fr Ligue 1,25,1998,21.5,40,21,25,14,1,16,27,59.3,11,35,19,16,21,61,117,4,Youssouf NdayishimiyeNice
Everton,Iliman Ndiaye,1865,sn SEN,FW,eng Premier League,24,2000,27.0,53,28,20,16,17,22,49,44.9,27,30,5,25,20,73,24,1,Iliman NdiayeEverton
Montpellier,Junior Ndiaye,1866,fr FRA,FW,fr Ligue 1,19,2005,4.9,3,2,2,1,0,1,4,25.0,3,2,1,1,0,3,2,0,Junior NdiayeMontpellier
Le Havre,Rassoul Ndiaye,1867,sn SEN,MF,fr Ligue 1,22,2001,11.8,35,25,19,12,4,11,25,44.0,14,15,4,11,12,47,24,0,Rassoul NdiayeLe Havre
Leicester City,Wilfred Ndidi,1868,ng NGA,MF,eng Premier League,27,1996,25.8,85,51,45,32,8,30,61,49.2,31,47,19,28,31,116,80,0,Wilfred NdidiLeicester City
Montpellier,Wilfried Ndollo,1869,cm CMR,DF,fr Ligue 1,19,2005,4.5,6,5,4,1,1,4,8,50.0,4,9,1,8,7,13,11,0,Wilfried NdolloMontpellier
Nice,Tanguy Ndombele,1870,fr FRA,MF,fr Ligue 1,27,1996,12.6,35,23,10,21,4,12,20,60.0,8,9,0,9,14,49,9,0,Tanguy NdombeleNice
Fiorentina,Cher Ndour,1871,it ITA,"MF,DF",it Serie A,20,2004,4.5,4,1,2,1,1,2,10,20.0,8,5,1,4,2,6,7,1,Cher NdourFiorentina
Bologna,Dan Ndoye,1872,ch SUI,FW,it Serie A,23,2000,23.8,26,19,8,8,10,16,28,57.1,12,23,0,23,9,35,4,0,Dan NdoyeBologna
Mainz 05,Paul Nebel,1873,de GER,MF,de Bundesliga,21,2002,26.1,38,24,11,18,9,11,35,31.4,24,54,4,50,13,51,30,2,Paul NebelMainz 05
Aston Villa,Kosta Nedeljkovic,1874,rs SRB,DF,eng Premier League,18,2005,1.4,7,5,1,3,3,2,3,66.7,1,1,0,1,0,7,3,0,Kosta NedeljkovicAston Villa
RB Leipzig,Kosta Nedeljkovic,1875,rs SRB,DF,de Bundesliga,18,2005,5.3,11,8,5,6,0,6,10,60.0,4,6,4,2,2,13,14,0,Kosta NedeljkovicRB Leipzig
Le Havre,Loic Nego,1876,hu HUN,"DF,FW",fr Ligue 1,33,1991,27.3,58,35,37,16,5,41,64,64.1,23,17,3,14,29,87,82,0,Loic NegoLe Havre
Holstein Kiel,Ivan Nekic,1877,hr CRO,DF,de Bundesliga,23,2000,0.8,1,1,1,0,0,1,2,50.0,1,1,0,1,3,4,2,0,Ivan NekicHolstein Kiel
Arsenal,Reiss Nelson,1878,eng ENG,FW,eng Premier League,24,1999,0.0,1,0,0,1,0,0,1,0.0,1,0,0,0,0,1,1,0,Reiss NelsonArsenal
Fulham,Reiss Nelson,1879,eng ENG,FW,eng Premier League,24,1999,5.4,8,6,3,3,2,5,13,38.5,8,11,0,11,5,13,2,0,Reiss NelsonFulham
Roma,Victor Nelsson,1880,dk DEN,DF,it Serie A,25,1998,2.1,5,4,3,1,1,3,5,60.0,2,1,0,1,2,7,9,0,Victor NelssonRoma
St. Pauli,David Nemeth,1881,at AUT,DF,de Bundesliga,23,2001,23.7,43,29,25,16,2,25,43,58.1,18,29,11,18,18,61,94,2,David NemethSt. Pauli
Napoli,David Neres,1882,br BRA,FW,it Serie A,27,1997,14.3,21,11,10,4,7,10,15,66.7,5,7,0,7,7,28,4,0,David NeresNapoli
Bournemouth,Neto,1883,br BRA,GK,eng Premier League,35,1989,2.0,0,0,0,0,0,0,0,,0,0,0,0,0,0,1,1,NetoBournemouth
Chelsea,Pedro Neto,1884,pt POR,FW,eng Premier League,24,2000,25.2,23,9,9,9,5,9,21,42.9,12,14,2,12,9,32,6,0,Pedro NetoChelsea
Gladbach,Luca Netz,1885,de GER,DF,de Bundesliga,21,2003,10.8,24,14,14,8,2,13,19,68.4,6,17,4,13,10,34,36,0,Luca NetzGladbach
Bayern Munich,Manuel Neuer,1886,de GER,GK,de Bundesliga,38,1986,22.0,1,0,1,0,0,1,1,100.0,0,0,0,0,0,1,9,1,Manuel NeuerBayern Munich
Gladbach,Florian Neuhaus,1887,de GER,MF,de Bundesliga,27,1997,4.2,10,3,7,3,0,7,17,41.2,10,9,2,7,6,16,5,1,Florian NeuhausGladbach
Paris S-G,Joao Neves,1888,pt POR,"MF,DF",fr Ligue 1,19,2004,20.5,63,31,20,26,17,27,45,60.0,18,29,9,20,23,86,22,1,Joao NevesParis S-G
Leganes,Yvan Neyou,1889,cm CMR,MF,es La Liga,27,1997,25.7,53,33,21,26,6,22,47,46.8,25,35,5,30,26,79,38,1,Yvan NeyouLeganes
Napoli,Cyril Ngonge,1890,be BEL,FW,it Serie A,24,2000,2.4,8,5,4,4,0,4,7,57.1,3,3,0,3,2,10,4,0,Cyril NgongeNapoli
Rennes,Mikayil Ngor Faye,1891,sn SEN,DF,fr Ligue 1,20,2004,7.6,15,12,10,3,2,7,9,77.8,2,9,4,5,12,27,30,0,Mikayil Ngor FayeRennes
Le Havre,Steve Ngoura,1892,fr FRA,FW,fr Ligue 1,19,2005,3.2,4,2,1,1,2,3,3,100.0,0,2,1,1,0,4,2,0,Steve NgouraLe Havre
Nice,Bernard Nguene,1893,cm CMR,FW,fr Ligue 1,17,2006,0.1,0,0,0,0,0,0,0,,0,0,0,0,0,0,0,0,Bernard NgueneNice
Lyon,Moussa Niakhate,1894,sn SEN,DF,fr Ligue 1,28,1996,30.3,47,27,37,8,2,24,32,75.0,8,26,17,9,25,72,143,3,Moussa NiakhateLyon
Brest,Abdoulaye Niakhate Ndiaye,1895,sn SEN,DF,fr Ligue 1,22,2002,19.0,49,33,36,12,1,25,37,67.6,12,29,17,12,11,60,144,3,Abdoulaye Niakhate NdiayeBrest
Angers,Ibrahima Niane,1896,sn SEN,FW,fr Ligue 1,25,1999,10.5,7,3,3,2,2,3,3,100.0,0,6,1,5,2,9,6,2,Ibrahima NianeAngers
Sevilla,Tanguy Nianzou,1897,fr FRA,DF,es La Liga,22,2002,5.8,7,5,6,0,1,5,6,83.3,1,1,0,1,8,15,27,0,Tanguy NianzouSevilla
Toulouse,Rasmus Nicolaisen,1898,dk DEN,DF,fr Ligue 1,27,1997,6.9,6,3,4,2,0,3,5,60.0,2,10,5,5,10,16,25,0,Rasmus NicolaisenToulouse
Gladbach,Moritz Nicolas,1899,de GER,GK,de Bundesliga,26,1997,18.2,0,0,0,0,0,0,0,,0,1,0,1,1,1,8,1,Moritz NicolasGladbach
Venezia,Hans Nicolussi Caviglia,1900,it ITA,MF,it Serie A,24,2000,31.8,47,28,17,22,8,29,64,45.3,35,39,12,27,28,75,55,2,Hans Nicolussi CavigliaVenezia
Heidenheim,Julian Niehues,1901,de GER,MF,de Bundesliga,23,2001,1.7,3,1,3,0,0,1,5,20.0,4,1,0,1,0,3,8,0,Julian NiehuesHeidenheim
Lazio,Oliver Nielsen,1902,dk DEN,DF,it Serie A,21,2003,0.4,0,0,0,0,0,0,0,,0,1,0,1,1,1,2,0,Oliver NielsenLazio
Sevilla,Saul Niguez,1903,es ESP,MF,es La Liga,29,1994,17.3,47,32,16,24,7,12,31,38.7,19,25,2,23,22,69,34,0,Saul NiguezSevilla
Torino,Eybi Nije,1904,se SWE,"FW,MF",it Serie A,19,2005,4.4,5,1,3,1,1,0,3,0.0,3,5,1,4,0,5,1,0,Eybi NijeTorino
Valladolid,Tamas Nikitscher,1905,hu HUN,"MF,DF",es La Liga,24,1999,9.5,17,8,8,9,0,8,13,61.5,5,17,4,13,11,28,16,1,Tamas NikitscherValladolid
Atletico Madrid,Adrian Nino,1906,es ESP,FW,es La Liga,20,2004,0.1,0,0,0,0,0,0,0,,0,0,0,0,0,0,0,0,Adrian NinoAtletico Madrid
Werder Bremen,Justin Njinmah,1907,de GER,"FW,MF",de Bundesliga,23,2000,10.6,6,2,1,4,1,3,5,60.0,2,5,0,5,3,9,1,0,Justin NjinmahWerder Bremen
Crystal Palace,Eddie Nketiah,1908,eng ENG,"FW,MF",eng Premier League,25,1999,11.5,15,8,7,4,4,7,13,53.8,6,10,1,9,3,18,12,0,Eddie NketiahCrystal Palace
Eint Frankfurt,Niels Nkounkou,1909,fr FRA,"DF,MF",de Bundesliga,23,2000,4.2,13,10,7,3,3,4,7,57.1,3,5,2,3,7,20,15,0,Niels NkounkouEint Frankfurt
Chelsea,Christopher Nkunku,1910,fr FRA,FW,eng Premier League,26,1997,10.2,12,8,3,4,5,6,8,75.0,2,9,2,7,7,19,10,0,Christopher NkunkuChelsea
Dortmund,Felix Nmecha,1911,de GER,MF,de Bundesliga,23,2000,16.8,34,22,6,19,9,12,22,54.5,10,20,5,15,23,57,30,1,Felix NmechaDortmund
Wolfsburg,Lukas Nmecha,1912,de GER,"FW,MF",de Bundesliga,25,1998,5.2,2,0,1,1,0,0,1,0.0,1,3,0,3,2,4,4,0,Lukas NmechaWolfsburg
Montpellier,Arnaud Nordin,1913,fr FRA,FW,fr Ligue 1,26,1998,13.0,24,15,6,16,2,11,21,52.4,10,12,0,12,5,29,7,0,Arnaud NordinMontpellier
Mainz 05,Arnaud Nordin,1914,fr FRA,"DF,MF",de Bundesliga,26,1998,0.9,2,0,0,2,0,1,1,100.0,0,2,1,1,0,2,2,0,Arnaud NordinMainz 05
Genoa,Brooke Norton-Cuffy,1915,eng ENG,"DF,FW",it Serie A,20,2004,8.0,12,7,9,3,0,9,11,81.8,2,12,2,10,3,15,12,0,Brooke Norton-CuffyGenoa
Lazio,Tijjani Noslin,1916,nl NED,"FW,MF",it Serie A,25,1999,9.6,6,5,2,1,3,1,8,12.5,7,15,1,14,1,7,7,0,Tijjani NoslinLazio
Alaves,Hugo Novoa,1917,es ESP,"DF,MF",es La Liga,21,2003,2.6,8,5,4,3,1,5,5,100.0,0,2,1,1,0,8,6,0,Hugo NovoaAlaves
Nantes,Plamedi Nsingi,1918,,MF,fr Ligue 1,23,2000,0.2,1,0,1,0,0,0,1,0.0,1,0,0,0,0,1,0,0,Plamedi NsingiNantes
Rayo Vallecano,Randy Nteka,1919,ao ANG,FW,es La Liga,26,1997,12.5,16,5,3,9,4,5,12,41.7,7,13,2,11,4,20,20,0,Randy NtekaRayo Vallecano
Lyon,Ernest Nuamah,1920,gh GHA,"FW,MF",fr Ligue 1,20,2003,11.7,21,11,15,4,2,12,27,44.4,15,9,1,8,8,29,8,1,Ernest NuamahLyon
Stuttgart,Alexander Nubel,1921,de GER,GK,de Bundesliga,27,1996,34.0,0,0,0,0,0,0,1,0.0,1,0,0,0,0,0,18,3,Alexander NubelStuttgart
Brentford,Gustavo Nunes,1922,br BRA,"FW,MF",eng Premier League,18,2005,0.1,3,2,2,0,1,2,2,100.0,0,0,0,0,0,3,2,0,Gustavo NunesBrentford
Manchester City,Matheus Nunes,1923,pt POR,"DF,MF",eng Premier League,25,1998,18.6,35,22,15,14,6,16,38,42.1,22,17,4,13,15,50,38,2,Matheus NunesManchester City
Liverpool,Darwin Nunez,1924,uy URU,FW,eng Premier League,25,1999,12.6,21,18,11,4,6,7,18,38.9,11,6,0,6,4,25,12,0,Darwin NunezLiverpool
Athletic Club,Unai Nunez,1925,es ESP,DF,es La Liga,27,1997,7.2,10,5,7,3,0,4,7,57.1,3,4,4,0,17,27,46,1,Unai NunezAthletic Club
RB Leipzig,Antonio Nusa,1926,no NOR,"MF,DF",de Bundesliga,19,2005,17.3,30,17,16,9,5,18,36,50.0,18,22,2,20,8,38,11,0,Antonio NusaRB Leipzig
Arsenal,Ethan Nwaneri,1927,eng ENG,"FW,MF",eng Premier League,17,2007,9.9,11,7,4,4,3,7,21,33.3,14,8,2,6,2,13,4,1,Ethan NwaneriArsenal
Sevilla,Orjan Nyland,1928,no NOR,GK,es La Liga,33,1990,29.7,3,2,3,0,0,3,5,60.0,2,0,0,0,0,3,12,4,Orjan NylandSevilla
Getafe,Allan Nyom,1929,cm CMR,"DF,MF",es La Liga,36,1988,9.9,18,11,7,9,2,15,17,88.2,2,4,2,2,4,22,23,0,Allan NyomGetafe
Montpellier,Rabby Nzingoula,1930,cg CGO,MF,fr Ligue 1,18,2005,18.8,64,42,26,31,7,27,58,46.6,31,27,5,22,29,93,23,0,Rabby NzingoulaMontpellier
Lens,M'Bala Nzola,1931,ao ANG,FW,fr Ligue 1,27,1996,16.2,5,4,0,1,4,3,9,33.3,6,9,1,8,5,10,7,0,M'Bala NzolaLens
Saint-Etienne,Marwann Nzuzi,1932,fr FRA,DF,fr Ligue 1,20,2004,1.4,2,2,1,0,1,1,2,50.0,1,0,0,0,2,4,6,0,Marwann NzuziSaint-Etienne
Brentford,Christian Norgaard,1933,dk DEN,MF,eng Premier League,30,1994,31.3,79,49,37,35,7,48,81,59.3,33,52,20,32,49,128,70,1,Christian NorgaardBrentford
Everton,Jake O'Brien,1934,ie IRL,DF,eng Premier League,23,2001,17.5,26,17,21,5,0,17,25,68.0,8,17,4,13,4,30,93,0,Jake O'BrienEverton
Brighton,Matt O'Riley,1935,dk DEN,MF,eng Premier League,23,2000,10.4,16,9,4,8,4,4,13,30.8,9,7,3,4,13,29,9,1,Matt O'RileyBrighton
Ipswich Town,Dara O'Shea,1936,ie IRL,DF,eng Premier League,25,1999,34.7,49,31,33,13,3,22,34,64.7,12,62,50,12,33,82,225,4,Dara O'SheaIpswich Town
Cagliari,Adam Obert,1937,sk SVK,DF,it Serie A,21,2002,12.0,31,18,12,17,2,16,27,59.3,11,19,7,12,23,54,48,2,Adam ObertCagliari
Manchester Utd,Chidozie Obi-Martin,1938,dk DEN,FW,eng Premier League,16,2007,1.8,2,1,0,0,2,2,2,100.0,0,0,0,0,0,2,1,0,Chidozie Obi-MartinManchester Utd
Atletico Madrid,Jan Oblak,1939,si SVN,GK,es La Liga,31,1993,36.0,0,0,0,0,0,0,0,,0,0,0,0,0,0,17,2,Jan OblakAtletico Madrid
Sevilla,Lucas Ocampos,1940,ar ARG,FW,es La Liga,30,1994,1.9,3,2,2,0,1,1,2,50.0,1,2,0,2,0,3,2,0,Lucas OcamposSevilla
Bologna,Jens Odgaard,1941,dk DEN,"MF,FW",it Serie A,25,1999,21.7,20,14,3,12,5,6,21,28.6,15,19,2,17,9,29,12,1,Jens OdgaardBologna
Tottenham,Wilson Odobert,1942,fr FRA,"FW,MF",eng Premier League,19,2004,9.4,14,5,5,4,5,8,14,57.1,6,6,0,6,4,18,5,1,Wilson OdobertTottenham
Wolfsburg,David Odogu,1943,de GER,DF,de Bundesliga,18,2006,2.2,6,4,4,2,0,3,5,60.0,2,2,2,0,2,8,25,1,David OdoguWolfsburg
Real Sociedad,Alvaro Odriozola,1944,es ESP,DF,es La Liga,28,1995,0.5,1,1,1,0,0,0,0,,0,0,0,0,0,1,1,0,Alvaro OdriozolaReal Sociedad
Bochum,Tim Oermann,1945,de GER,DF,de Bundesliga,20,2003,24.6,50,31,25,21,4,26,43,60.5,17,32,16,16,22,72,64,0,Tim OermannBochum
Ipswich Town,Chiedozie Ogbene,1946,ie IRL,FW,eng Premier League,27,1997,2.6,7,3,1,2,4,2,4,50.0,2,1,0,1,1,8,3,0,Chiedozie OgbeneIpswich Town
Freiburg,Ifechukwu Ogbus,1947,ch SUI,DF,de Bundesliga,18,2005,0.2,1,1,0,0,1,0,1,0.0,1,0,0,0,1,2,2,0,Ifechukwu OgbusFreiburg
Villarreal,Thiago Ojeda,1948,ar ARG,MF,es La Liga,21,2003,0.1,0,0,0,0,0,0,0,,0,0,0,0,0,0,1,0,Thiago OjedaVillarreal
Lens,Hamzat Ojediran,1949,ng NGA,"MF,FW",fr Ligue 1,20,2003,4.6,28,15,12,13,3,7,19,36.8,12,10,2,8,10,38,7,0,Hamzat OjediranLens
Napoli,Noah Okafor,1950,ch SUI,"FW,MF",it Serie A,24,2000,0.4,3,2,3,0,0,2,2,100.0,0,0,0,0,0,3,1,0,Noah OkaforNapoli
Milan,Noah Okafor,1951,ch SUI,FW,it Serie A,24,2000,4.6,2,1,0,0,2,0,1,0.0,1,1,0,1,2,4,1,0,Noah OkaforMilan
Leicester City,Caleb Okoli,1952,it ITA,DF,eng Premier League,23,2001,12.5,25,14,8,15,2,11,18,61.1,7,24,14,10,15,40,79,3,Caleb OkoliLeicester City
Hellas Verona,Yllan Okou,1953,fr FRA,DF,it Serie A,21,2002,0.0,0,0,0,0,0,0,0,,0,1,0,1,0,0,0,0,Yllan OkouHellas Verona
Udinese,Maduka Okoye,1954,ng NGA,GK,it Serie A,24,1999,25.0,0,0,0,0,0,0,0,,0,0,0,0,0,0,12,1,Maduka OkoyeUdinese
Reims,Joseph Okumu,1955,ke KEN,DF,fr Ligue 1,27,1997,18.8,30,15,21,9,0,15,24,62.5,9,33,21,12,25,55,137,2,Joseph OkumuReims
Athletic Club,Aingeru Olabarrieta,1956,es ESP,FW,es La Liga,18,2005,0.6,0,0,0,0,0,0,0,,0,2,0,2,1,1,1,0,Aingeru OlabarrietaAthletic Club
Rennes,Kazeem Olaigbe,1957,be BEL,"MF,FW",fr Ligue 1,21,2003,3.3,6,4,3,3,0,3,6,50.0,3,3,1,2,0,6,0,0,Kazeem OlaigbeRennes
Real Sociedad,Olasagasti,1958,es ESP,MF,es La Liga,23,2000,9.5,21,10,7,9,5,8,18,44.4,10,8,2,6,15,36,10,0,OlasagastiReal Sociedad
Saint-Etienne,Ben Old,1959,nz NZL,"FW,MF",fr Ligue 1,21,2002,5.9,7,5,3,3,1,3,11,27.3,8,8,1,7,2,9,2,0,Ben OldSaint-Etienne
Hoffenheim,Finn Ole Becker,1960,de GER,MF,de Bundesliga,24,2000,7.4,11,5,4,6,1,1,4,25.0,3,7,3,4,10,21,20,0,Finn Ole BeckerHoffenheim
Bayern Munich,Michael Olise,1961,fr FRA,"FW,MF",de Bundesliga,22,2001,25.9,36,23,10,21,5,17,38,44.7,21,23,1,22,8,44,16,2,Michael OliseBayern Munich
Espanyol,Brian Olivan,1962,es ESP,DF,es La Liga,30,1994,11.3,13,10,7,6,0,4,13,30.8,9,6,2,4,10,23,23,0,Brian OlivanEspanyol
Valladolid,Lucas Oliveira Rosa,1963,br BRA,DF,es La Liga,24,2000,21.0,53,33,40,11,2,35,51,68.6,16,24,9,15,28,81,69,2,Lucas Oliveira RosaValladolid
Napoli,Mathias Olivera,1964,uy URU,DF,it Serie A,26,1997,26.3,63,35,31,25,7,32,53,60.4,21,36,12,24,28,91,74,1,Mathias OliveraNapoli
Barcelona,Dani Olmo,1965,es ESP,"MF,FW",es La Liga,26,1998,13.5,16,11,8,5,3,4,14,28.6,10,6,3,3,3,19,11,1,Dani OlmoBarcelona
Aston Villa,Robin Olsen,1966,se SWE,GK,eng Premier League,34,1990,2.5,1,0,1,0,0,1,1,100.0,0,0,0,0,0,1,2,1,Robin OlsenAston Villa
Lyon,Warmed Omari,1967,km COM,DF,fr Ligue 1,24,2000,0.1,0,0,0,0,0,0,0,,0,0,0,0,0,0,1,0,Warmed OmariLyon
Montpellier,Becir Omeragic,1968,ch SUI,DF,fr Ligue 1,22,2002,20.0,32,16,19,12,1,16,21,76.2,5,32,21,11,13,45,78,0,Becir OmeragicMontpellier
Gladbach,Jonas Omlin,1969,ch SUI,GK,de Bundesliga,30,1994,10.9,0,0,0,0,0,0,1,0.0,1,0,0,0,0,0,5,1,Jonas OmlinGladbach
Strasbourg,Andrew Omobamidele,1970,ie IRL,DF,fr Ligue 1,22,2002,6.0,7,4,4,3,0,2,5,40.0,3,12,8,4,8,15,41,0,Andrew OmobamideleStrasbourg
Auxerre,Ado Onaiwu,1971,jp JPN,"MF,FW",fr Ligue 1,28,1995,10.6,11,7,2,6,3,4,14,28.6,10,12,0,12,3,14,12,0,Ado OnaiwuAuxerre
Aston Villa,Amadou Onana,1972,be BEL,MF,eng Premier League,22,2001,18.0,55,30,23,26,6,16,29,55.2,13,16,7,9,26,81,41,3,Amadou OnanaAston Villa
Manchester Utd,Andre Onana,1973,cm CMR,GK,eng Premier League,28,1996,34.0,2,2,2,0,0,2,4,50.0,2,0,0,0,0,2,11,4,Andre OnanaManchester Utd
Genoa,Jean Onana,1974,cm CMR,MF,it Serie A,24,2000,3.4,12,6,2,10,0,5,9,55.6,4,6,1,5,4,16,8,1,Jean OnanaGenoa
Parma,Jacob Ondrejka,1975,se SWE,"MF,FW",it Serie A,21,2002,4.7,12,6,5,7,0,10,12,83.3,2,2,0,2,7,19,2,0,Jacob OndrejkaParma
Mainz 05,Karim Onisiwo,1976,at AUT,"MF,FW",de Bundesliga,32,1992,1.2,1,1,0,0,1,0,0,,0,0,0,0,0,1,0,0,Karim OnisiwoMainz 05
Southampton,Paul Onuachu,1977,ng NGA,FW,eng Premier League,30,1994,11.7,7,2,1,5,1,3,7,42.9,4,7,2,5,1,8,16,1,Paul OnuachuSouthampton
Brentford,Frank Onyeka,1978,ng NGA,MF,eng Premier League,26,1998,0.3,0,0,0,0,0,0,0,,0,0,0,0,0,0,0,0,Frank OnyekaBrentford
Augsburg,Frank Onyeka,1979,ng NGA,MF,de Bundesliga,26,1998,28.7,58,45,22,28,8,22,40,55.0,18,36,9,27,36,94,36,2,Frank OnyekaAugsburg
RB Leipzig,Lois Openda,1980,be BEL,"FW,MF",de Bundesliga,24,2000,27.3,9,4,3,4,2,3,11,27.3,8,19,1,18,5,14,12,0,Lois OpendaRB Leipzig
Le Havre,Christopher Operi,1981,ci CIV,"DF,FW",fr Ligue 1,27,1997,13.0,13,9,6,2,5,7,12,58.3,5,20,6,14,14,27,30,0,Christopher OperiLe Havre
Auxerre,Fredrik Oppegard,1982,no NOR,DF,fr Ligue 1,21,2002,3.0,6,4,4,1,1,3,7,42.9,4,2,1,1,2,8,12,1,Fredrik OppegardAuxerre
Nice,Victor Orakpo,1983,ng NGA,FW,fr Ligue 1,18,2006,0.4,0,0,0,0,0,0,0,,0,0,0,0,0,0,0,0,Victor OrakpoNice
Reims,Ike Orazi,1984,ie IRL,MF,fr Ligue 1,17,2007,0.0,0,0,0,0,0,0,0,,0,0,0,0,0,0,0,0,Ike OraziReims
Lyon,Gift Orban,1985,ng NGA,"FW,DF",fr Ligue 1,22,2002,2.1,0,0,0,0,0,0,1,0.0,1,0,0,0,0,0,0,0,Gift OrbanLyon
Hoffenheim,Gift Orban,1986,ng NGA,FW,de Bundesliga,22,2002,7.6,3,1,2,1,0,1,6,16.7,5,7,0,7,0,3,3,0,Gift OrbanHoffenheim
RB Leipzig,Willi Orban,1987,hu HUN,DF,de Bundesliga,31,1992,24.7,38,21,23,14,1,23,32,71.9,9,45,31,14,21,59,169,4,Willi OrbanRB Leipzig
Bochum,Ivan Ordets,1988,ua UKR,DF,de Bundesliga,32,1992,20.7,18,8,13,5,0,10,13,76.9,3,29,16,13,41,59,139,3,Ivan OrdetsBochum
West Ham,Lewis Orford,1989,eng ENG,MF,eng Premier League,18,2006,0.5,0,0,0,0,0,0,0,,0,1,0,1,1,1,0,0,Lewis OrfordWest Ham
Venezia,Gaetano Oristanio,1990,it ITA,"FW,MF",it Serie A,21,2002,25.7,17,13,5,8,4,7,15,46.7,8,16,0,16,6,23,6,1,Gaetano OristanioVenezia
Osasuna,Aimar Oroz,1991,es ESP,MF,es La Liga,22,2001,33.0,35,19,16,13,6,14,46,30.4,32,29,2,27,20,55,10,0,Aimar OrozOsasuna
Bologna,Riccardo Orsolini,1992,it ITA,FW,it Serie A,27,1997,20.9,16,13,6,6,4,5,11,45.5,6,26,0,26,8,24,10,1,Riccardo OrsoliniBologna
Manchester City,Stefan Ortega,1993,de GER,GK,eng Premier League,31,1992,12.2,0,0,0,0,0,0,1,0.0,1,0,0,0,0,0,11,1,Stefan OrtegaManchester City
Betis,Angel Ortiz,1994,es ESP,DF,es La Liga,20,2004,3.9,12,8,8,3,1,8,17,47.1,9,6,0,6,5,17,7,0,Angel OrtizBetis
Girona,Gabriel Osei Misehouy,1995,nl NED,"FW,MF",es La Liga,19,2005,2.9,1,1,0,1,0,0,1,0.0,1,0,0,0,0,1,0,0,Gabriel Osei MisehouyGirona
Auxerre,Gabriel Osho,1996,ng NGA,DF,fr Ligue 1,25,1998,18.4,23,15,17,3,3,13,20,65.0,7,32,19,13,12,35,87,0,Gabriel OshoAuxerre
Parma,Yordan Osorio,1997,ve VEN,DF,it Serie A,30,1994,1.9,5,3,4,1,0,2,2,100.0,0,3,1,2,4,9,6,1,Yordan OsorioParma
Freiburg,Patrick Osterhage,1998,de GER,MF,de Bundesliga,24,2000,25.2,45,29,16,27,2,14,30,46.7,16,27,3,24,18,63,37,0,Patrick OsterhageFreiburg
Newcastle Utd,William Osula,1999,dk DEN,FW,eng Premier League,20,2003,1.5,2,0,1,0,1,0,2,0.0,2,0,0,0,4,6,2,0,William OsulaNewcastle Utd
Saint-Etienne,Jibril Othman,2000,tn TUN,FW,fr Ligue 1,20,2004,0.1,0,0,0,0,0,0,0,,0,0,0,0,0,0,0,0,Jibril OthmanSaint-Etienne
Genoa,Sebastian Otoa,2001,dk DEN,DF,it Serie A,20,2004,2.0,1,0,1,0,0,1,2,50.0,1,1,1,0,3,4,14,0,Sebastian OtoaGenoa
Valencia,David Otorbi,2002,es ESP,MF,es La Liga,16,2007,0.2,0,0,0,0,0,0,0,,0,1,0,1,0,0,0,0,David OtorbiValencia
Bournemouth,Dango Ouattara,2003,bf BFA,FW,eng Premier League,22,2002,22.3,35,26,14,11,10,17,41,41.5,24,36,10,26,11,46,51,0,Dango OuattaraBournemouth
Strasbourg,Guimissongui Ouattara,2004,fr FRA,"DF,FW",fr Ligue 1,18,2005,5.2,6,4,3,1,2,3,5,60.0,2,10,0,10,9,15,12,2,Guimissongui OuattaraStrasbourg
Monaco,Kassoum Ouattara,2005,fr FRA,"DF,FW",fr Ligue 1,19,2004,4.3,9,7,5,4,0,4,14,28.6,10,6,0,6,5,14,2,1,Kassoum OuattaraMonaco
Lecce,Remi Oudin,2006,fr FRA,"MF,FW",it Serie A,27,1996,3.3,3,1,1,1,1,2,4,50.0,2,6,2,4,2,5,1,0,Remi OudinLecce
RB Leipzig,Assan Ouedraogo,2007,de GER,MF,de Bundesliga,18,2006,0.6,0,0,0,0,0,0,0,,0,1,0,1,0,0,0,0,Assan OuedraogoRB Leipzig
Angers,Zinedine Ould Khaled,2008,fr FRA,MF,fr Ligue 1,24,2000,3.8,9,7,5,3,1,2,13,15.4,11,6,1,5,2,11,12,0,Zinedine Ould KhaledAngers
Venezia,Cheick Oumar Conde,2009,gn GUI,MF,it Serie A,24,2000,1.7,6,5,3,2,1,2,5,40.0,3,7,2,5,4,10,3,0,Cheick Oumar CondeVenezia
Alaves,Jesus Owono,2010,gq EQG,GK,es La Liga,23,2001,5.4,1,1,1,0,0,1,1,100.0,0,0,0,0,0,1,2,0,Jesus OwonoAlaves
Saint-Etienne,Beres Owusu,2011,fr FRA,DF,fr Ligue 1,20,2003,1.0,2,2,1,1,0,2,2,100.0,0,2,2,0,0,2,5,0,Beres OwusuSaint-Etienne
Auxerre,Elisha Owusu,2012,gh GHA,MF,fr Ligue 1,26,1997,26.0,73,41,29,39,5,31,48,64.6,17,33,9,24,42,115,35,1,Elisha OwusuAuxerre
Real Sociedad,Mikel Oyarzabal,2013,es ESP,FW,es La Liga,27,1997,25.0,25,16,9,10,6,10,23,43.5,13,17,1,16,4,29,15,0,Mikel OyarzabalReal Sociedad
Hellas Verona,Daniel Oyegoke,2014,eng ENG,DF,it Serie A,21,2003,1.1,2,2,1,0,1,1,1,100.0,0,1,0,1,1,3,7,0,Daniel OyegokeHellas Verona
Wolfsburg,Salih Ozcan,2015,tr TUR,MF,de Bundesliga,26,1998,3.9,2,2,1,0,1,1,5,20.0,4,5,1,4,7,9,5,0,Salih OzcanWolfsburg
Dortmund,Salih Ozcan,2016,tr TUR,MF,de Bundesliga,26,1998,4.3,11,7,6,4,1,7,13,53.8,6,7,0,7,11,22,10,0,Salih OzcanDortmund
Valladolid,Cenk Ozkacar,2017,tr TUR,DF,es La Liga,23,2000,8.4,9,5,7,2,0,4,14,28.6,10,9,6,3,18,27,69,1,Cenk OzkacarValladolid
Manchester City,Nico O'Reilly,2018,eng ENG,DF,eng Premier League,19,2005,5.9,9,4,3,3,3,4,8,50.0,4,5,1,4,4,13,12,0,Nico O'ReillyManchester City
Real Sociedad,Jon Pacheco,2019,es ESP,DF,es La Liga,23,2001,9.5,15,9,12,3,0,10,12,83.3,2,8,6,2,9,24,49,2,Jon PachecoReal Sociedad
Paris S-G,Willian Pacho,2020,ec ECU,DF,fr Ligue 1,22,2001,23.7,56,32,34,22,0,23,32,71.9,9,35,22,13,40,96,91,1,Willian PachoParis S-G
Udinese,Daniele Padelli,2021,it ITA,GK,it Serie A,38,1985,1.0,0,0,0,0,0,0,1,0.0,1,0,0,0,0,0,0,0,Daniele PadelliUdinese
Athletic Club,Alex Padilla,2022,es ESP,GK,es La Liga,20,2003,3.6,0,0,0,0,0,0,0,,0,0,0,0,0,0,2,1,Alex PadillaAthletic Club
Udinese,Simone Pafundi,2023,it ITA,"MF,DF",it Serie A,18,2006,1.3,3,3,2,0,1,1,4,25.0,3,0,0,0,0,3,1,0,Simone PafundiUdinese
Leverkusen,Exequiel Palacios,2024,ar ARG,MF,de Bundesliga,25,1998,12.8,22,15,8,10,4,10,18,55.6,8,14,1,13,13,35,15,1,Exequiel PalaciosLeverkusen
Monza,Tomas Palacios,2025,ar ARG,DF,it Serie A,21,2003,5.0,11,5,9,2,0,9,13,69.2,4,7,2,5,8,19,17,2,Tomas PalaciosMonza
Inter,Tomas Palacios,2026,ar ARG,DF,it Serie A,21,2003,0.1,0,0,0,0,0,0,0,,0,0,0,0,1,1,0,0,Tomas PalaciosInter
Rayo Vallecano,Isaac Palazon Camacho,2027,es ESP,"MF,FW",es La Liga,29,1994,24.0,22,17,10,6,6,8,34,23.5,26,22,3,19,8,30,13,1,Isaac Palazon CamachoRayo Vallecano
Torino,Alberto Paleari,2028,it ITA,GK,it Serie A,31,1992,1.0,0,0,0,0,0,0,0,,0,0,0,0,0,0,2,0,Alberto PaleariTorino
Atalanta,Marco Palestra,2029,it ITA,DF,it Serie A,19,2005,2.5,6,4,3,2,1,3,3,100.0,0,4,1,3,2,8,4,0,Marco PalestraAtalanta
Bayern Munich,Joao Palhinha,2030,pt POR,MF,de Bundesliga,29,1995,7.5,20,14,6,11,3,11,16,68.8,5,13,1,12,4,24,9,1,Joao PalhinhaBayern Munich
Nantes,Nicolas Pallois,2031,fr FRA,DF,fr Ligue 1,36,1987,22.4,61,27,44,13,4,37,63,58.7,26,48,18,30,28,89,164,3,Nicolas PalloisNantes
Udinese,Matteo Palma,2032,de GER,DF,it Serie A,16,2008,0.1,0,0,0,0,0,0,0,,0,1,1,0,0,0,1,0,Matteo PalmaUdinese
Ipswich Town,Alex Palmer,2033,eng ENG,GK,eng Premier League,27,1996,13.0,0,0,0,0,0,0,0,,0,0,0,0,0,0,12,0,Alex PalmerIpswich Town
Chelsea,Cole Palmer,2034,eng ENG,"MF,FW",eng Premier League,22,2002,35.5,34,20,12,10,12,12,27,44.4,15,16,1,15,11,45,20,1,Cole PalmerChelsea
West Ham,Emerson Palmieri,2035,it ITA,DF,eng Premier League,29,1994,23.5,60,31,37,18,5,27,48,56.3,21,32,8,24,21,81,59,0,Emerson PalmieriWest Ham
Bochum,Mats Pannewig,2036,de GER,MF,de Bundesliga,19,2004,3.0,10,6,7,3,0,3,12,25.0,9,8,1,7,2,12,8,0,Mats PannewigBochum
West Ham,Lucas Paqueta,2037,br BRA,"MF,FW",eng Premier League,26,1997,26.4,66,37,25,30,11,27,55,49.1,28,29,4,25,18,84,37,6,Lucas PaquetaWest Ham
Athletic Club,Aitor Paredes,2038,es ESP,DF,es La Liga,24,2000,20.1,15,13,10,5,0,8,15,53.3,7,26,15,11,22,37,114,4,Aitor ParedesAthletic Club
Wolfsburg,Kevin Paredes,2039,us USA,DF,de Bundesliga,21,2003,1.4,3,1,3,0,0,2,3,66.7,1,2,2,0,1,4,0,0,Kevin ParedesWolfsburg
Roma,Leandro Paredes,2040,ar ARG,MF,it Serie A,30,1994,15.3,26,14,9,12,5,16,32,50.0,16,14,5,9,19,45,33,2,Leandro ParedesRoma
Villarreal,Daniel Parejo,2041,es ESP,MF,es La Liga,35,1989,25.3,52,40,27,20,5,29,54,53.7,25,24,7,17,24,76,40,1,Daniel ParejoVillarreal
Valladolid,Iago Parente,2042,es ESP,DF,es La Liga,18,2006,0.8,0,0,0,0,0,0,0,,0,0,0,0,0,0,2,0,Iago ParenteValladolid
Fiorentina,Fabiano Parisi,2043,it ITA,"DF,MF",it Serie A,23,2000,11.7,27,17,11,12,4,12,21,57.1,9,14,2,12,17,44,17,0,Fabiano ParisiFiorentina
Arsenal,Thomas Partey,2044,gh GHA,"MF,DF",eng Premier League,31,1993,31.1,89,53,26,39,24,46,76,60.5,30,29,9,20,35,124,49,4,Thomas ParteyArsenal
Atalanta,Mario Pasalic,2045,hr CRO,MF,it Serie A,29,1995,21.9,26,16,11,13,2,11,26,42.3,15,22,7,15,12,38,28,1,Mario PasalicAtalanta
Sevilla,Alvaro Pascual,2046,es ESP,FW,es La Liga,22,2002,4.5,5,3,0,3,2,1,5,20.0,4,4,0,4,2,7,9,0,Alvaro PascualSevilla
Bochum,Felix Passlack,2047,de GER,"DF,MF",de Bundesliga,26,1998,25.9,53,23,32,13,8,30,55,54.5,25,42,11,31,18,71,63,1,Felix PasslackBochum
Lazio,Patric,2048,es ESP,DF,it Serie A,31,1993,6.7,9,6,6,3,0,6,10,60.0,4,3,2,1,3,12,22,1,PatricLazio
Atalanta,Rui Patricio,2049,pt POR,GK,it Serie A,36,1988,3.0,0,0,0,0,0,0,0,,0,0,0,0,0,0,3,0,Rui PatricioAtalanta
Everton,Nathan Patterson,2050,sct SCO,DF,eng Premier League,22,2001,3.9,11,6,7,4,0,7,14,50.0,7,2,0,2,2,13,7,0,Nathan PattersonEverton
Inter,Benjamin Pavard,2051,fr FRA,DF,it Serie A,28,1996,17.6,29,16,12,12,5,18,25,72.0,7,16,12,4,16,45,52,0,Benjamin PavardInter
Bayern Munich,Aleksandar Pavlovic,2052,de GER,MF,de Bundesliga,20,2004,16.1,38,21,13,15,10,22,32,68.8,10,18,3,15,5,43,14,0,Aleksandar PavlovicBayern Munich
Milan,Strahinja Pavlovic,2053,rs SRB,DF,it Serie A,23,2001,20.7,52,31,32,19,1,29,50,58.0,21,17,6,11,16,68,82,0,Strahinja PavlovicMilan
Cagliari,Leonardo Pavoletti,2054,it ITA,"FW,MF",it Serie A,35,1988,4.9,1,0,0,1,0,0,0,,0,4,1,3,0,1,3,0,Leonardo PavolettiCagliari
Udinese,Martin Payero,2055,ar ARG,MF,it Serie A,25,1998,15.3,24,16,4,14,6,8,16,50.0,8,16,2,14,13,37,13,0,Martin PayeroUdinese
Montpellier,Nicolas Pays,2056,fr FRA,"FW,MF",fr Ligue 1,20,2003,5.0,13,6,3,4,6,4,8,50.0,4,1,0,1,4,17,2,0,Nicolas PaysMontpellier
Como,Nicolas Paz,2057,ar ARG,"MF,FW",it Serie A,19,2004,29.9,51,33,18,26,7,24,51,47.1,27,49,3,46,21,72,16,0,Nicolas PazComo
Augsburg,Mads Pedersen,2058,dk DEN,DF,de Bundesliga,27,1996,2.6,8,7,5,2,1,4,5,80.0,1,4,0,4,2,10,6,0,Mads PedersenAugsburg
Torino,Marcus Pedersen,2059,no NOR,DF,it Serie A,24,2000,15.1,13,8,6,6,1,10,16,62.5,6,11,2,9,13,26,34,1,Marcus PedersenTorino
Villarreal,Alfonso Pedraza,2060,es ESP,"DF,MF",es La Liga,28,1996,5.1,3,2,2,0,1,2,4,50.0,2,3,1,2,6,9,16,0,Alfonso PedrazaVillarreal
Barcelona,Pedri,2061,es ESP,MF,es La Liga,21,2002,32.0,61,34,14,38,9,24,70,34.3,46,45,3,42,26,87,21,1,PedriBarcelona
Lazio,Pedro,2062,es ESP,"FW,MF",it Serie A,37,1987,12.2,19,14,5,9,5,10,21,47.6,11,11,0,11,3,22,3,1,PedroLazio
Saint-Etienne,Kevin Pedro,2063,fr FRA,DF,fr Ligue 1,18,2006,0.1,3,0,2,1,0,3,3,100.0,0,1,0,1,2,5,1,0,Kevin PedroSaint-Etienne
Sevilla,Adria Pedrosa,2064,es ESP,DF,es La Liga,26,1998,25.5,56,32,34,16,6,31,54,57.4,23,43,11,32,24,80,85,0,Adria PedrosaSevilla
Reims,Jordan Pefok,2065,us USA,FW,fr Ligue 1,28,1996,4.2,3,2,0,3,0,2,3,66.7,1,3,1,2,2,5,5,0,Jordan PefokReims
Union Berlin,Jordan Pefok,2066,us USA,FW,de Bundesliga,28,1996,10.1,11,6,6,0,5,3,7,42.9,4,9,2,7,4,15,18,0,Jordan PefokUnion Berlin
Las Palmas,Pejino,2067,es ESP,FW,es La Liga,28,1996,0.2,1,1,0,1,0,1,1,100.0,0,0,0,0,0,1,0,0,PejinoLas Palmas
Empoli,Pietro Pellegri,2068,it ITA,FW,it Serie A,23,2001,4.6,7,2,0,6,1,2,4,50.0,2,2,0,2,0,7,3,0,Pietro PellegriEmpoli
Roma,Lorenzo Pellegrini,2069,it ITA,MF,it Serie A,28,1996,18.1,24,16,5,13,6,8,19,42.1,11,8,1,7,6,30,22,0,Lorenzo PellegriniRoma
Lazio,Luca Pellegrini,2070,it ITA,DF,it Serie A,25,1999,11.9,23,11,11,10,2,17,32,53.1,15,10,3,7,19,42,32,0,Luca PellegriniLazio
Parma,Mateo Pellegrino,2071,ar ARG,FW,it Serie A,23,2001,8.2,3,2,1,2,0,1,4,25.0,3,6,1,5,1,4,6,0,Mateo PellegrinoParma
Auxerre,Theo Pellenard,2072,fr FRA,DF,fr Ligue 1,30,1994,0.5,3,2,2,1,0,1,3,33.3,2,1,0,1,0,3,3,0,Theo PellenardAuxerre
Lecce,Andy Pelmard,2073,fr FRA,DF,it Serie A,24,2000,1.4,6,6,5,1,0,4,4,100.0,0,1,0,1,0,6,5,0,Andy PelmardLecce
Las Palmas,Andy Pelmard,2074,fr FRA,DF,es La Liga,24,2000,2.3,5,0,3,2,0,4,5,80.0,1,3,1,2,2,7,20,0,Andy PelmardLas Palmas
Le Havre,Timothee Pembele,2075,fr FRA,DF,fr Ligue 1,21,2002,12.4,30,22,17,9,4,14,23,60.9,9,16,5,11,11,41,42,0,Timothee PembeleLe Havre
Marseille,Faris Pemi Moumbagna,2076,cm CMR,FW,fr Ligue 1,24,2000,0.1,0,0,0,0,0,0,0,,0,0,0,0,0,0,0,0,Faris Pemi MoumbagnaMarseille
Barcelona,Inaki Pena,2077,es ESP,GK,es La Liga,25,1999,15.5,0,0,0,0,0,0,2,0.0,2,0,0,0,0,0,20,1,Inaki PenaBarcelona
Osasuna,Ruben Pena,2078,es ESP,"FW,DF",es La Liga,33,1991,8.6,12,5,4,3,5,5,24,20.8,19,11,0,11,6,18,12,0,Ruben PenaOsasuna
Villarreal,Nicolas Pepe,2079,ci CIV,"FW,MF",es La Liga,29,1995,16.7,22,9,12,6,4,6,17,35.3,11,12,1,11,5,27,12,0,Nicolas PepeVillarreal
Sevilla,Peque,2080,es ESP,"MF,FW",es La Liga,21,2002,12.6,16,5,4,10,2,7,17,41.2,10,16,0,16,8,24,5,0,PequeSevilla
Torino,Sergiu Perciun,2081,md MDA,"FW,MF",it Serie A,18,2006,1.7,2,2,0,0,2,1,4,25.0,3,2,0,2,1,3,2,0,Sergiu PerciunTorino
Strasbourg,Oscar Perea,2082,co COL,"MF,DF",fr Ligue 1,18,2005,0.2,0,0,0,0,0,0,0,,0,0,0,0,0,0,0,0,Oscar PereaStrasbourg
Fulham,Andreas Pereira,2083,br BRA,MF,eng Premier League,28,1996,22.4,24,13,8,11,5,10,42,23.8,32,17,2,15,8,32,17,3,Andreas PereiraFulham
Brest,Mathias Pereira Lage,2084,pt POR,"FW,MF",fr Ligue 1,27,1996,17.5,37,24,16,13,8,18,39,46.2,21,17,2,15,20,57,20,2,Mathias Pereira LageBrest
Monza,Pedro Pereira,2085,pt POR,DF,it Serie A,26,1998,29.6,53,32,30,18,5,35,55,63.6,20,26,12,14,21,74,85,5,Pedro PereiraMonza
Leicester City,Ricardo Pereira,2086,pt POR,DF,eng Premier League,30,1993,4.3,13,8,4,6,3,7,14,50.0,7,8,3,5,4,17,11,0,Ricardo PereiraLeicester City
Genoa,Gaston Pereiro,2087,uy URU,MF,it Serie A,29,1995,0.3,1,0,0,1,0,1,1,100.0,0,0,0,0,0,1,1,0,Gaston PereiroGenoa
Bayern Munich,Daniel Peretz,2088,il ISR,GK,de Bundesliga,24,2000,3.0,0,0,0,0,0,0,1,0.0,1,0,0,0,0,0,2,0,Daniel PeretzBayern Munich
Villarreal,Ayoze Perez,2089,es ESP,FW,es La Liga,31,1993,21.9,27,14,5,18,4,6,24,25.0,18,17,0,17,8,35,15,0,Ayoze PerezVillarreal
Getafe,Carles Perez,2090,es ESP,"MF,FW",es La Liga,26,1998,15.9,33,23,11,14,8,21,48,43.8,27,19,2,17,6,39,22,0,Carles PerezGetafe
Valencia,Francisco Perez,2091,es ESP,"FW,MF",es La Liga,21,2002,6.3,17,12,7,8,2,10,16,62.5,6,8,1,7,3,20,6,0,Francisco PerezValencia
Venezia,Kike Perez,2092,es ESP,MF,it Serie A,27,1997,12.4,41,25,18,12,11,18,44,40.9,26,14,2,12,10,51,15,0,Kike PerezVenezia
Valladolid,Kike Perez,2093,es ESP,MF,es La Liga,27,1997,13.2,37,26,15,19,3,15,26,57.7,11,16,4,12,7,44,18,0,Kike PerezValladolid
Valladolid,Luis Perez,2094,es ESP,DF,es La Liga,29,1995,28.4,41,30,25,11,5,24,40,60.0,16,26,9,17,29,70,86,0,Luis PerezValladolid
Udinese,Nehuen Perez,2095,ar ARG,DF,it Serie A,24,2000,2.0,1,1,0,0,1,0,1,0.0,1,2,2,0,1,2,7,0,Nehuen PerezUdinese
Hellas Verona,Simone Perilli,2096,it ITA,GK,it Serie A,29,1995,2.0,0,0,0,0,0,0,0,,0,0,0,0,0,0,1,0,Simone PerilliHellas Verona
Juventus,Mattia Perin,2097,it ITA,GK,it Serie A,31,1992,5.0,0,0,0,0,0,0,0,,0,0,0,0,0,0,2,0,Mattia PerinJuventus
Betis,Romain Perraud,2098,fr FRA,DF,es La Liga,26,1997,22.2,36,22,15,16,5,21,46,45.7,25,18,4,14,22,58,71,1,Romain PerraudBetis
Lyon,Lucas Perri,2099,br BRA,GK,fr Ligue 1,26,1997,33.0,1,1,1,0,0,0,4,0.0,4,1,0,1,0,1,22,1,Lucas PerriLyon
Auxerre,Gaetan Perrin,2100,fr FRA,"MF,FW",fr Ligue 1,28,1996,29.9,49,26,22,12,15,21,48,43.8,27,10,0,10,12,61,4,1,Gaetan PerrinAuxerre
Como,Maximo Perrone,2101,ar ARG,MF,it Serie A,21,2003,20.6,38,27,19,14,5,13,38,34.2,25,15,2,13,20,58,43,0,Maximo PerroneComo
Gladbach,Noah Pesch,2102,hr CRO,FW,de Bundesliga,19,2005,0.1,1,0,0,0,1,0,0,,0,0,0,0,0,1,0,0,Noah PeschGladbach
Monza,Matteo Pessina,2103,it ITA,MF,it Serie A,27,1997,9.5,15,4,3,11,1,9,14,64.3,5,6,0,6,12,27,7,0,Matteo PessinaMonza
Monza,Andrea Petagna,2104,it ITA,FW,it Serie A,29,1995,3.7,2,1,0,1,1,1,2,50.0,1,0,0,0,1,3,2,0,Andrea PetagnaMonza
Angers,Prosper Peter,2105,ng NGA,"MF,FW",fr Ligue 1,16,2007,0.3,2,1,0,2,0,0,0,,0,0,0,0,0,2,0,0,Prosper PeterAngers
Saint-Etienne,Leo Petrot,2106,fr FRA,DF,fr Ligue 1,27,1997,29.3,62,39,38,19,5,34,51,66.7,17,50,27,23,42,104,103,1,Leo PetrotSaint-Etienne
Strasbourg,Dorde Petrovic,2107,rs SRB,GK,fr Ligue 1,24,1999,31.0,1,1,1,0,0,0,0,,0,0,0,0,0,1,24,1,Dorde PetrovicStrasbourg
Empoli,Giuseppe Pezzella,2108,it ITA,"DF,FW",it Serie A,26,1997,32.0,55,31,28,17,10,29,57,50.9,28,32,8,24,15,70,110,2,Giuseppe PezzellaEmpoli
Las Palmas,Valentin Pezzolesi,2109,es ESP,DF,es La Liga,17,2007,0.1,0,0,0,0,0,0,0,,0,0,0,0,0,0,1,1,Valentin PezzolesiLas Palmas
Hoffenheim,Luca Philipp,2110,de GER,GK,de Bundesliga,23,2000,6.0,1,0,1,0,0,1,1,100.0,0,0,0,0,0,1,1,0,Luca PhilippHoffenheim
Freiburg,Maximilian Philipp,2111,de GER,"MF,FW",de Bundesliga,30,1994,0.2,0,0,0,0,0,0,0,,0,0,0,0,0,0,0,0,Maximilian PhilippFreiburg
Ipswich Town,Kalvin Phillips,2112,eng ENG,MF,eng Premier League,28,1995,13.7,35,19,8,20,7,15,39,38.5,24,35,6,29,19,54,37,2,Kalvin PhillipsIpswich Town
Aston Villa,Jaden Philogene Bidace,2113,eng ENG,"FW,MF",eng Premier League,22,2002,3.7,11,5,4,7,0,4,6,66.7,2,5,0,5,3,14,2,1,Jaden Philogene BidaceAston Villa
Ipswich Town,Jaden Philogene Bidace,2114,eng ENG,"FW,DF",eng Premier League,22,2002,5.3,14,7,6,6,2,8,15,53.3,7,11,1,10,10,24,9,1,Jaden Philogene BidaceIpswich Town
Alaves,Pica,2115,es ESP,DF,es La Liga,22,2002,5.5,9,7,7,2,0,4,9,44.4,5,7,6,1,9,18,26,0,PicaAlaves
Cagliari,Roberto Piccoli,2116,it ITA,FW,it Serie A,23,2001,34.7,13,9,2,6,5,3,12,25.0,9,12,4,8,3,16,31,0,Roberto PiccoliCagliari
Holstein Kiel,Benedikt Pichler,2117,at AUT,FW,de Bundesliga,27,1997,8.7,5,2,1,0,4,2,4,50.0,2,4,2,2,2,7,11,0,Benedikt PichlerHolstein Kiel
Everton,Jordan Pickford,2118,eng ENG,GK,eng Premier League,30,1994,38.0,1,0,1,0,0,1,2,50.0,1,0,0,0,1,2,30,2,Jordan PickfordEverton
Werder Bremen,Amos Pieper,2119,de GER,DF,de Bundesliga,26,1998,16.6,32,17,16,11,5,21,33,63.6,12,28,17,11,24,56,98,1,Amos PieperWerder Bremen
Heidenheim,Marvin Pieringer,2120,de GER,"FW,MF",de Bundesliga,24,1999,24.5,23,13,5,12,6,5,10,50.0,5,21,2,19,8,31,32,0,Marvin PieringerHeidenheim
Venezia,Nicholas Pierini,2121,it ITA,MF,it Serie A,25,1998,0.9,0,0,0,0,0,0,1,0.0,1,2,0,2,0,0,0,0,Nicholas PieriniVenezia
Lecce,Santiago Pierotti,2122,ar ARG,FW,it Serie A,23,2001,21.5,46,24,22,18,6,23,51,45.1,28,31,5,26,14,60,32,0,Santiago PierottiLecce
Lecce,Balthazar Pierret,2123,fr FRA,MF,it Serie A,24,2000,19.1,51,31,25,23,3,13,30,43.3,17,19,5,14,19,70,31,1,Balthazar PierretLecce
Genoa,Andrea Pinamonti,2124,it ITA,FW,it Serie A,25,1999,31.7,10,6,0,7,3,2,8,25.0,6,16,4,12,1,11,28,2,Andrea PinamontiGenoa
Brentford,Ethan Pinnock,2125,jm JAM,DF,eng Premier League,31,1993,21.3,35,19,15,16,4,13,24,54.2,11,29,18,11,24,59,142,4,Ethan PinnockBrentford
Villarreal,Yeremi Pino,2126,es ESP,"MF,FW",es La Liga,21,2002,21.5,60,32,20,32,8,32,65,49.2,33,38,3,35,8,68,18,0,Yeremi PinoVillarreal
Cagliari,Nicola Pintus,2127,it ITA,DF,it Serie A,19,2005,0.0,0,0,0,0,0,0,0,,0,0,0,0,0,0,2,0,Nicola PintusCagliari
Roma,Niccolo Pisilli,2128,it ITA,MF,it Serie A,19,2004,13.6,24,11,11,8,5,12,22,54.5,10,14,3,11,11,35,16,0,Niccolo PisilliRoma
Udinese,Damian Pizarro,2129,cl CHI,"FW,MF",it Serie A,19,2005,0.2,0,0,0,0,0,0,0,,0,0,0,0,0,0,0,0,Damian PizarroUdinese
Monza,Semuel Pizzignacco,2130,it ITA,GK,it Serie A,22,2001,8.2,0,0,0,0,0,0,1,0.0,1,0,0,0,0,0,6,0,Semuel PizzignaccoMonza
Gladbach,Alassane Plea,2131,fr FRA,"MF,FW",de Bundesliga,31,1993,21.1,7,3,0,2,5,4,13,30.8,9,11,0,11,2,9,7,1,Alassane PleaGladbach
Bologna,Tommaso Pobega,2132,it ITA,MF,it Serie A,25,1999,13.1,33,19,12,15,6,22,30,73.3,8,16,4,12,14,47,16,0,Tommaso PobegaBologna
Wolves,Daniel Podence,2133,pt POR,"MF,FW",eng Premier League,28,1995,0.5,0,0,0,0,0,0,1,0.0,1,0,0,0,0,0,0,0,Daniel PodenceWolves
Venezia,Joel Pohjanpalo,2134,fi FIN,FW,it Serie A,29,1994,17.8,3,3,1,2,0,0,4,0.0,4,7,4,3,4,7,24,0,Joel PohjanpaloVenezia
Napoli,Matteo Politano,2135,it ITA,"FW,MF",it Serie A,30,1993,31.2,29,15,17,11,1,15,43,34.9,28,21,1,20,13,42,50,1,Matteo PolitanoNapoli
Wolves,Alfie Pond,2136,eng ENG,DF,eng Premier League,20,2004,0.0,0,0,0,0,0,0,0,,0,0,0,0,0,0,0,0,Alfie PondWolves
Fiorentina,Marin Pongracic,2137,hr CRO,DF,it Serie A,26,1997,14.4,18,13,13,4,1,7,11,63.6,4,14,6,8,12,30,69,2,Marin PongracicFiorentina
Newcastle Utd,Nick Pope,2138,eng ENG,GK,eng Premier League,32,1992,28.0,0,0,0,0,0,0,0,,0,1,0,1,1,1,32,5,Nick PopeNewcastle Utd
Holstein Kiel,Finn Porath,2139,de GER,"DF,MF",de Bundesliga,27,1997,21.9,45,26,24,14,7,26,53,49.1,27,27,9,18,21,66,67,0,Finn PorathHolstein Kiel
Tottenham,Pedro Porro,2140,es ESP,DF,eng Premier League,24,1999,29.0,66,49,34,22,10,44,77,57.1,33,44,17,27,36,102,84,2,Pedro PorroTottenham
Girona,Portu,2141,es ESP,"FW,MF",es La Liga,32,1992,8.7,13,7,5,5,3,7,10,70.0,3,8,0,8,0,13,2,0,PortuGirona
Bologna,Stefan Posch,2142,at AUT,DF,it Serie A,27,1997,7.9,26,15,12,9,5,15,25,60.0,10,19,4,15,5,31,22,0,Stefan PoschBologna
Atalanta,Stefan Posch,2143,at AUT,DF,it Serie A,27,1997,4.3,18,11,7,8,3,8,9,88.9,1,5,1,4,4,22,13,0,Stefan PoschAtalanta
Lens,Tom Pouilly,2144,fr FRA,"DF,MF",fr Ligue 1,21,2003,3.0,9,6,5,1,3,5,10,50.0,5,5,1,4,4,13,11,0,Tom PouillyLens
RB Leipzig,Yussuf Poulsen,2145,dk DEN,"FW,MF",de Bundesliga,30,1994,4.2,10,5,2,6,2,4,8,50.0,4,7,2,5,0,10,14,0,Yussuf PoulsenRB Leipzig
Athletic Club,Benat Prados,2146,es ESP,MF,es La Liga,23,2001,19.1,55,36,20,27,8,25,53,47.2,28,21,2,19,28,83,26,0,Benat PradosAthletic Club
Hoffenheim,Alexander Prass,2147,at AUT,DF,de Bundesliga,23,2001,17.4,42,23,24,15,3,24,59,40.7,35,33,6,27,9,51,53,4,Alexander PrassHoffenheim
Cagliari,Matteo Prati,2148,it ITA,MF,it Serie A,20,2003,6.3,10,4,2,7,1,3,11,27.3,8,5,2,3,7,17,10,1,Matteo PratiCagliari
Mallorca,Abdon Prats,2149,es ESP,"FW,MF",es La Liga,31,1992,5.1,2,1,1,1,0,1,2,50.0,1,2,1,1,1,3,5,0,Abdon PratsMallorca
Union Berlin,David Preu,2150,de GER,"MF,DF",de Bundesliga,19,2004,1.3,1,1,0,1,0,0,2,0.0,2,4,2,2,0,1,2,0,David PreuUnion Berlin
Hoffenheim,Grischa Promel,2151,de GER,MF,de Bundesliga,29,1995,1.9,0,0,0,0,0,0,1,0.0,1,1,1,0,2,2,4,0,Grischa PromelHoffenheim
Lazio,Ivan Provedel,2152,it ITA,GK,it Serie A,30,1994,29.0,0,0,0,0,0,0,0,,0,1,0,1,1,1,12,3,Ivan ProvedelLazio
Union Berlin,Ivan Prtajin,2153,hr CRO,FW,de Bundesliga,28,1996,1.8,3,2,0,1,2,0,0,,0,2,0,2,0,3,3,0,Ivan PrtajinUnion Berlin
Espanyol,Javi Puado,2154,es ESP,"FW,MF",es La Liga,26,1998,33.0,22,17,14,4,4,8,20,40.0,12,18,3,15,5,27,19,0,Javi PuadoEspanyol
Holstein Kiel,Tymoteusz Puchacz,2155,pl POL,DF,de Bundesliga,25,1999,4.4,9,4,6,3,0,5,7,71.4,2,4,1,3,3,12,11,0,Tymoteusz PuchaczHolstein Kiel
Juventus,Diego Pugno,2156,it ITA,FW,it Serie A,18,2006,0.1,0,0,0,0,0,0,0,,0,0,0,0,0,0,0,0,Diego PugnoJuventus
Milan,Christian Pulisic,2157,us USA,"FW,MF",it Serie A,25,1998,27.5,43,29,17,14,12,15,37,40.5,22,24,2,22,5,48,13,2,Christian PulisicMilan
Liverpool,Jarell Quansah,2158,eng ENG,DF,eng Premier League,21,2003,5.5,12,8,8,4,0,7,10,70.0,3,10,7,3,7,19,28,1,Jarell QuansahLiverpool
Union Berlin,Leopold Querfeld,2159,at AUT,DF,de Bundesliga,20,2003,19.4,25,12,21,4,0,13,18,72.2,5,25,10,15,19,44,144,2,Leopold QuerfeldUnion Berlin
Leganes,Dani Raba,2160,es ESP,"FW,MF",es La Liga,28,1995,20.9,37,23,17,15,5,17,42,40.5,25,27,3,24,14,51,19,1,Dani RabaLeganes
Marseille,Adrien Rabiot,2161,fr FRA,MF,fr Ligue 1,29,1995,27.6,49,31,17,21,11,19,32,59.4,13,21,2,19,21,70,32,0,Adrien RabiotMarseille
Venezia,Ionut Radu,2162,ro ROU,GK,it Serie A,27,1997,15.0,0,0,0,0,0,0,0,,0,0,0,0,0,0,9,0,Ionut RaduVenezia
Lecce,Hamza Rafia,2163,tn TUN,MF,it Serie A,25,1999,11.8,44,27,14,25,5,15,32,46.9,17,7,2,5,4,48,18,1,Hamza RafiaLecce
Brentford,Hakon Rafn Valdimarsson,2164,is ISL,GK,eng Premier League,22,2001,1.6,0,0,0,0,0,0,0,,0,0,0,0,0,0,2,0,Hakon Rafn ValdimarssonBrentford
Valladolid,Arnau Rafus,2165,es ESP,GK,es La Liga,21,2003,1.0,0,0,0,0,0,0,0,,0,0,0,0,0,0,0,1,Arnau RafusValladolid
Mallorca,Antonio Raillo,2166,es ESP,DF,es La Liga,32,1991,35.6,31,18,18,10,3,14,20,70.0,6,51,38,13,29,60,222,1,Antonio RailloMallorca
Venezia,Antonio Raimondo,2167,it ITA,"FW,DF",it Serie A,20,2004,1.0,2,1,1,1,0,0,0,,0,0,0,0,0,2,0,1,Antonio RaimondoVenezia
Lecce,Ylber Ramadani,2168,al ALB,MF,it Serie A,28,1996,20.1,51,28,24,27,0,33,52,63.5,19,26,9,17,24,75,26,3,Ylber RamadaniLecce
Las Palmas,Benito Ramirez,2169,es ESP,"DF,FW",es La Liga,29,1995,5.3,10,5,4,6,0,9,16,56.3,7,8,3,5,1,11,14,1,Benito RamirezLas Palmas
Las Palmas,Sandro Ramirez,2170,es ESP,"FW,MF",es La Liga,29,1995,22.6,27,15,10,13,4,13,30,43.3,17,20,0,20,16,43,22,2,Sandro RamirezLas Palmas
Real Madrid,Jacobo Ramon,2171,es ESP,DF,es La Liga,19,2005,2.3,7,3,4,3,0,2,2,100.0,0,1,0,1,3,10,8,2,Jacobo RamonReal Madrid
Paris S-G,Goncalo Ramos,2172,pt POR,FW,fr Ligue 1,23,2001,11.8,11,6,5,5,1,3,6,50.0,3,5,1,4,0,11,5,0,Goncalo RamosParis S-G
Southampton,Aaron Ramsdale,2173,eng ENG,GK,eng Premier League,26,1998,30.0,0,0,0,0,0,0,3,0.0,3,0,0,0,2,2,10,3,Aaron RamsdaleSouthampton
Aston Villa,Jacob Ramsey,2174,eng ENG,"FW,MF",eng Premier League,23,2001,18.0,30,15,14,10,6,10,20,50.0,10,23,4,19,8,38,8,1,Jacob RamseyAston Villa
Fiorentina,Luca Ranieri,2175,it ITA,DF,it Serie A,25,1999,33.1,42,24,28,12,2,20,25,80.0,5,47,32,15,27,69,154,1,Luca RanieriFiorentina
Gladbach,Grant Ranos,2176,am ARM,FW,de Bundesliga,21,2003,0.2,1,0,0,1,0,0,1,0.0,1,2,0,2,0,1,0,0,Grant RanosGladbach
Angers,Lilian Raolisoa,2177,fr FRA,"DF,FW",fr Ligue 1,24,2000,14.6,41,24,24,13,4,17,38,44.7,21,11,2,9,15,56,45,0,Lilian RaolisoaAngers
Barcelona,Raphinha,2178,br BRA,"FW,MF",es La Liga,27,1996,31.5,36,22,6,19,11,19,39,48.7,20,29,2,27,11,47,26,0,RaphinhaBarcelona
Manchester Utd,Marcus Rashford,2179,eng ENG,"FW,MF",eng Premier League,26,1997,10.9,7,4,2,2,3,3,9,33.3,6,8,0,8,4,11,7,0,Marcus RashfordManchester Utd
Aston Villa,Marcus Rashford,2180,eng ENG,FW,eng Premier League,26,1997,4.9,10,7,2,3,5,4,6,66.7,2,2,0,2,1,11,3,0,Marcus RashfordAston Villa
Napoli,Giacomo Raspadori,2181,it ITA,"FW,MF",it Serie A,24,2000,12.3,18,9,6,10,2,8,12,66.7,4,10,2,8,3,21,13,0,Giacomo RaspadoriNapoli
Rayo Vallecano,Andrei Ratiu,2182,ro ROU,DF,es La Liga,26,1998,34.1,71,41,40,21,10,42,70,60.0,28,45,5,40,27,98,73,2,Andrei RatiuRayo Vallecano
Osasuna,Raul,2183,es ESP,"FW,MF",es La Liga,23,2000,8.3,13,8,3,6,4,5,10,50.0,5,4,0,4,0,13,6,0,RaulOsasuna
RB Leipzig,David Raum,2184,de GER,DF,de Bundesliga,26,1998,19.8,38,28,16,14,8,20,35,57.1,15,25,8,17,9,47,47,4,David RaumRB Leipzig
Bologna,Federico Ravaglia,2185,it ITA,GK,it Serie A,24,1999,11.7,0,0,0,0,0,0,0,,0,0,0,0,0,0,9,0,Federico RavagliaBologna
Auxerre,Rayan Raveloson,2186,mg MAD,"MF,DF",fr Ligue 1,27,1997,8.0,6,5,2,4,0,5,15,33.3,10,8,7,1,5,11,22,0,Rayan RavelosonAuxerre
Arsenal,David Raya,2187,es ESP,GK,eng Premier League,28,1995,38.0,0,0,0,0,0,0,2,0.0,2,0,0,0,2,2,21,9,David RayaArsenal
Alaves,Abderrahman Rebbach,2188,dz ALG,"FW,MF",es La Liga,25,1998,4.3,3,2,3,0,0,0,6,0.0,6,4,0,4,0,3,6,0,Abderrahman RebbachAlaves
Lecce,Ante Rebic,2189,hr CRO,"FW,MF",it Serie A,30,1993,8.8,12,9,5,5,2,3,9,33.3,6,7,1,6,2,14,4,1,Ante RebicLecce
Fulham,Harrison Reed,2190,eng ENG,MF,eng Premier League,29,1995,1.2,6,3,3,2,1,1,3,33.3,2,1,0,1,1,7,3,0,Harrison ReedFulham
Bournemouth,Remy Rees-Dottin,2191,eng ENG,FW,eng Premier League,18,2006,0.0,0,0,0,0,0,0,0,,0,0,0,0,0,0,0,0,Remy Rees-DottinBournemouth
Tottenham,Sergio Reguilon,2192,es ESP,DF,eng Premier League,27,1996,2.2,4,3,1,3,0,2,5,40.0,3,7,0,7,4,8,8,0,Sergio ReguilonTottenham
Milan,Tijjani Reijnders,2193,nl NED,MF,it Serie A,26,1998,34.8,26,13,6,14,6,10,26,38.5,16,22,4,18,38,64,28,2,Tijjani ReijndersMilan
Como,Pepe Reina,2194,es ESP,GK,it Serie A,41,1982,11.5,0,0,0,0,0,0,1,0.0,1,0,0,0,0,0,3,2,Pepe ReinaComo
Manchester City,Vitor Reis,2195,br BRA,DF,eng Premier League,18,2006,0.0,0,0,0,0,0,0,0,,0,0,0,0,0,0,1,0,Vitor ReisManchester City
Gladbach,Rocco Reitz,2196,de GER,MF,de Bundesliga,22,2002,20.3,52,24,24,24,4,24,43,55.8,19,39,16,23,53,105,59,2,Rocco ReitzGladbach
Holstein Kiel,Nicolai Remberg,2197,de GER,MF,de Bundesliga,24,2000,26.9,45,25,24,17,4,19,41,46.3,22,46,20,26,29,74,100,0,Nicolai RembergHolstein Kiel
Real Sociedad,Alex Remiro,2198,es ESP,GK,es La Liga,29,1995,36.0,1,0,1,0,0,1,2,50.0,1,0,0,0,0,1,18,4,Alex RemiroReal Sociedad
Roma,Devyne Rensch,2199,nl NED,DF,it Serie A,21,2003,5.2,17,13,8,8,1,9,10,90.0,1,5,3,2,7,24,12,1,Devyne RenschRoma
Villarreal,Daniel Requena,2200,es ESP,MF,es La Liga,20,2004,0.1,0,0,0,0,0,0,0,,0,0,0,0,0,0,0,0,Daniel RequenaVillarreal
Toulouse,Guillaume Restes,2201,fr FRA,GK,fr Ligue 1,19,2005,28.3,2,1,2,0,0,2,3,66.7,1,0,0,0,1,3,16,1,Guillaume RestesToulouse
Atalanta,Mateo Retegui,2202,it ITA,FW,it Serie A,25,1999,26.5,14,9,0,9,5,3,16,18.8,13,7,0,7,4,18,17,0,Mateo ReteguiAtalanta
Augsburg,Elvis Rexhbecaj,2203,xk KVX,MF,de Bundesliga,26,1997,19.8,27,19,9,14,4,15,35,42.9,20,40,9,31,16,43,22,1,Elvis RexhbecajAugsburg
Dortmund,Gio Reyna,2204,us USA,MF,de Bundesliga,21,2002,3.9,7,0,3,0,4,4,5,80.0,1,3,1,2,0,7,9,0,Gio ReynaDortmund
Crystal Palace,Chadi Riad,2205,ma MAR,DF,eng Premier League,21,2003,1.0,5,2,2,2,1,2,3,66.7,1,0,0,0,2,7,0,0,Chadi RiadCrystal Palace
Lille,Alexsandro Ribeiro,2206,br BRA,DF,fr Ligue 1,24,1999,30.0,32,19,18,13,1,20,30,66.7,10,23,13,10,27,59,143,3,Alexsandro RibeiroLille
Torino,Samuele Ricci,2207,it ITA,MF,it Serie A,22,2001,31.4,35,21,15,14,6,18,28,64.3,10,23,9,14,25,60,51,2,Samuele RicciTorino
Arsenal,Declan Rice,2208,eng ENG,MF,eng Premier League,25,1999,31.4,53,25,22,25,6,17,41,41.5,24,27,13,14,25,78,51,0,Declan RiceArsenal
Crystal Palace,Chris Richards,2209,us USA,DF,eng Premier League,24,2000,21.4,47,30,24,17,6,24,41,58.5,17,40,14,26,19,66,121,0,Chris RichardsCrystal Palace
Fiorentina,Amir Richardson,2210,ma MAR,MF,it Serie A,22,2002,11.4,30,13,13,15,2,9,21,42.9,12,14,1,13,6,36,29,1,Amir RichardsonFiorentina
Tottenham,Richarlison,2211,br BRA,FW,eng Premier League,27,1997,5.6,5,3,0,4,1,0,3,0.0,3,1,1,0,0,5,8,0,RicharlisonTottenham
Getafe,Diego Rico,2212,es ESP,DF,es La Liga,31,1993,31.3,81,49,47,29,5,47,85,55.3,38,41,3,38,34,115,102,2,Diego RicoGetafe
Stuttgart,Fabian Rieder,2213,ch SUI,"MF,FW",de Bundesliga,22,2002,9.6,17,14,4,9,4,7,23,30.4,16,10,1,9,10,27,7,1,Fabian RiederStuttgart
Mainz 05,Lasse Riess,2214,de GER,GK,de Bundesliga,23,2001,2.0,0,0,0,0,0,0,0,,0,0,0,0,0,0,5,0,Lasse RiessMainz 05
Alaves,Luis Rioja,2215,es ESP,FW,es La Liga,30,1993,0.3,2,1,0,1,1,1,2,50.0,1,2,0,2,0,2,0,0,Luis RiojaAlaves
Valencia,Luis Rioja,2216,es ESP,"MF,FW",es La Liga,30,1993,31.5,33,21,14,12,7,14,42,33.3,28,30,1,29,22,55,44,1,Luis RiojaValencia
Atletico Madrid,Rodrigo Riquelme,2217,es ESP,"MF,DF",es La Liga,24,2000,5.7,11,5,4,6,1,6,11,54.5,5,3,0,3,2,13,3,0,Rodrigo RiquelmeAtletico Madrid
Getafe,Alberto Risco,2218,es ESP,"MF,FW",es La Liga,18,2005,0.8,4,4,2,0,2,1,6,16.7,5,2,0,2,0,4,0,0,Alberto RiscoGetafe
Celta Vigo,Mihailo Ristic,2219,rs SRB,"DF,MF",es La Liga,28,1995,4.8,7,7,4,2,1,4,6,66.7,2,1,0,1,2,9,18,0,Mihailo RisticCelta Vigo
St. Pauli,Lars Ritzka,2220,de GER,"DF,MF",de Bundesliga,26,1998,10.2,49,29,28,16,5,25,41,61.0,16,16,2,14,11,60,41,0,Lars RitzkaSt. Pauli
Getafe,Gorka Rivera Alonso,2221,es ESP,"DF,MF",es La Liga,19,2004,0.2,2,0,0,2,0,2,2,100.0,0,0,0,0,0,2,0,0,Gorka Rivera AlonsoGetafe
Como,Sergi Roberto,2222,es ESP,MF,it Serie A,32,1992,7.7,14,8,5,5,4,5,7,71.4,2,7,1,6,9,23,14,0,Sergi RobertoComo
Liverpool,Andrew Robertson,2223,sct SCO,DF,eng Premier League,30,1994,27.6,39,22,25,10,4,31,51,60.8,20,10,4,6,21,60,54,2,Andrew RobertsonLiverpool
Fulham,Antonee Robinson,2224,us USA,DF,eng Premier League,26,1997,35.2,95,61,57,31,7,45,95,47.4,50,43,9,34,62,157,133,2,Antonee RobinsonFulham
Southampton,Jay Robinson,2225,eng ENG,"MF,FW",eng Premier League,17,2007,1.5,4,1,3,0,1,1,1,100.0,0,0,0,0,0,4,1,0,Jay RobinsonSouthampton
Betis,Marc Roca,2226,es ESP,MF,es La Liga,27,1996,10.1,20,14,10,9,1,9,17,52.9,8,17,5,12,14,34,14,2,Marc RocaBetis
Manchester City,Rodri,2227,es ESP,MF,eng Premier League,28,1996,0.8,2,1,1,1,0,0,0,,0,1,0,1,1,3,1,0,RodriManchester City
Betis,Rodri,2228,es ESP,FW,es La Liga,24,2000,1.3,2,1,1,1,0,1,2,50.0,1,2,1,1,1,3,1,1,RodriBetis
Alaves,Adrian Rodriguez,2229,es ESP,GK,es La Liga,23,2000,1.4,0,0,0,0,0,0,1,0.0,1,0,0,0,0,0,3,1,Adrian RodriguezAlaves
Lyon,Alejandro Rodriguez,2230,pt POR,MF,fr Ligue 1,16,2008,0.2,0,0,0,0,0,0,0,,0,0,0,0,0,0,0,0,Alejandro RodriguezLyon
Getafe,Alvaro Rodriguez,2231,uy URU,FW,es La Liga,20,2004,9.5,10,7,0,7,3,5,10,50.0,5,23,0,23,3,13,12,0,Alvaro RodriguezGetafe
Leganes,Oscar Rodriguez Arnaiz,2232,es ESP,"MF,FW",es La Liga,26,1998,14.8,32,17,10,16,6,14,32,43.8,18,10,1,9,20,52,20,0,Oscar Rodriguez ArnaizLeganes
Las Palmas,Arturo Rodriguez,2233,es ESP,FW,es La Liga,17,2006,0.2,0,0,0,0,0,0,0,,0,0,0,0,0,0,0,0,Arturo RodriguezLas Palmas
Celta Vigo,Damian Rodriguez,2234,es ESP,MF,es La Liga,21,2003,10.3,14,9,3,10,1,6,16,37.5,10,6,1,5,7,21,13,0,Damian RodriguezCelta Vigo
Mallorca,Dani Rodriguez,2235,es ESP,"MF,FW",es La Liga,36,1988,24.0,49,29,18,21,10,14,27,51.9,13,22,3,19,12,61,30,0,Dani RodriguezMallorca
Barcelona,Daniel Rodriguez,2236,es ESP,FW,es La Liga,18,2005,0.4,0,0,0,0,0,0,0,,0,1,0,1,0,0,0,0,Daniel RodriguezBarcelona
West Ham,Guido Rodriguez,2237,ar ARG,MF,eng Premier League,30,1994,12.8,36,19,21,15,0,17,33,51.5,16,23,9,14,13,49,35,1,Guido RodriguezWest Ham
Rayo Vallecano,James Rodriguez,2238,co COL,"MF,FW",es La Liga,33,1991,1.6,3,2,1,2,0,0,2,0.0,2,2,0,2,1,4,0,0,James RodriguezRayo Vallecano
Celta Vigo,Javi Rodriguez,2239,es ESP,DF,es La Liga,21,2003,27.9,53,38,35,17,1,33,47,70.2,14,29,10,19,33,86,96,2,Javi RodriguezCelta Vigo
Betis,Jesus Rodriguez,2240,es ESP,FW,es La Liga,18,2005,12.3,16,14,6,6,4,5,18,27.8,13,16,0,16,6,22,3,0,Jesus RodriguezBetis
Las Palmas,Kirian Rodriguez,2241,es ESP,MF,es La Liga,28,1996,19.5,33,17,12,18,3,22,43,51.2,21,22,4,18,10,43,21,0,Kirian RodriguezLas Palmas
Betis,Ricardo Rodriguez,2242,ch SUI,DF,es La Liga,31,1992,14.2,28,15,16,5,7,17,26,65.4,9,10,1,9,8,36,51,0,Ricardo RodriguezBetis
Real Madrid,Rodrygo,2243,br BRA,"FW,MF",es La Liga,23,2001,21.4,21,14,14,5,2,7,23,30.4,16,18,1,17,11,32,9,0,RodrygoReal Madrid
Brentford,Mads Roerslev,2244,dk DEN,DF,eng Premier League,25,1999,12.2,18,8,14,3,1,11,28,39.3,17,12,5,7,4,22,35,0,Mads RoerslevBrentford
Wolfsburg,Mads Roerslev,2245,dk DEN,DF,de Bundesliga,25,1999,3.3,10,9,8,1,1,6,9,66.7,3,2,2,0,5,15,16,0,Mads RoerslevWolfsburg
Aston Villa,Morgan Rogers,2246,eng ENG,"FW,MF",eng Premier League,22,2002,34.6,43,22,15,15,13,24,47,51.1,23,26,7,19,6,49,20,2,Morgan RogersAston Villa
Freiburg,Merlin Rohl,2247,de GER,"MF,FW",de Bundesliga,22,2002,10.7,16,10,4,10,2,9,11,81.8,2,9,1,8,6,22,2,0,Merlin RohlFreiburg
Lazio,Alessio Romagnoli,2248,it ITA,DF,it Serie A,29,1995,29.7,48,29,20,26,2,22,27,81.5,5,33,17,16,26,74,118,1,Alessio RomagnoliLazio
Mallorca,Leo Roman,2249,es ESP,GK,es La Liga,24,2000,7.0,0,0,0,0,0,0,0,,0,0,0,0,0,0,6,0,Leo RomanMallorca
Espanyol,Carlos Romero,2250,es ESP,DF,es La Liga,22,2001,28.4,73,47,49,16,8,45,82,54.9,37,50,15,35,30,103,102,1,Carlos RomeroEspanyol
Tottenham,Cristian Romero,2251,ar ARG,DF,eng Premier League,26,1998,15.7,35,29,26,8,1,21,30,70.0,9,18,3,15,21,56,57,2,Cristian RomeroTottenham
Sevilla,Isaac Romero,2252,es ESP,FW,es La Liga,24,2000,24.0,13,7,4,4,5,3,16,18.8,13,18,1,17,7,20,27,0,Isaac RomeroSevilla
Alaves,Luka Romero,2253,ar ARG,"FW,MF",es La Liga,19,2004,2.2,4,4,1,1,2,2,3,66.7,1,2,0,2,1,5,0,0,Luka RomeroAlaves
Girona,Oriol Romeu,2254,es ESP,MF,es La Liga,32,1991,15.1,38,25,14,19,5,14,26,53.8,12,22,8,14,12,50,20,4,Oriol RomeuGirona
Marseille,Valentin Rongier,2255,fr FRA,"MF,DF",fr Ligue 1,29,1994,17.4,50,28,14,31,5,27,43,62.8,16,30,9,21,33,83,28,5,Valentin RongierMarseille
Atalanta,Marten de Roon,2256,nl NED,"MF,DF",it Serie A,33,1991,34.0,74,48,32,38,4,30,66,45.5,36,40,7,33,47,121,67,1,Marten de RoonAtalanta
Betis,Vitor Roque,2257,br BRA,FW,es La Liga,19,2005,13.7,11,6,1,6,4,1,5,20.0,4,5,0,5,7,18,4,0,Vitor RoqueBetis
Nice,Pablo Rosario,2258,do DOM,"MF,DF",fr Ligue 1,27,1997,19.7,30,20,6,19,5,11,20,55.0,9,19,11,8,31,61,43,2,Pablo RosarioNice
Holstein Kiel,Lasse Rosenboom,2259,de GER,DF,de Bundesliga,22,2002,19.3,47,35,25,16,6,32,47,68.1,15,28,9,19,19,66,71,3,Lasse RosenboomHolstein Kiel
Freiburg,Max Rosenfelder,2260,de GER,DF,de Bundesliga,21,2003,13.9,27,17,17,10,0,14,19,73.7,5,17,9,8,7,34,65,0,Max RosenfelderFreiburg
Leganes,Valentin Rosier,2261,fr FRA,DF,es La Liga,27,1996,28.8,72,52,48,16,8,43,68,63.2,25,40,15,25,52,124,149,2,Valentin RosierLeganes
Union Berlin,Tom Rothe,2262,de GER,"DF,MF",de Bundesliga,19,2004,18.6,45,28,27,15,3,29,51,56.9,22,41,5,36,18,63,57,1,Tom RotheUnion Berlin
Rennes,Anthony Rouault,2263,fr FRA,DF,fr Ligue 1,23,2001,10.8,12,8,10,2,0,4,4,100.0,0,13,11,2,8,20,65,0,Anthony RouaultRennes
Stuttgart,Anthony Rouault,2264,fr FRA,DF,de Bundesliga,23,2001,13.5,15,11,10,3,2,10,15,66.7,5,18,9,9,19,34,63,1,Anthony RouaultStuttgart
Juventus,Jonas Rouhi,2265,se SWE,DF,it Serie A,20,2004,2.3,4,1,1,3,0,0,1,0.0,1,2,0,2,3,7,2,0,Jonas RouhiJuventus
Union Berlin,Jerome Roussillon,2266,fr FRA,"DF,MF",de Bundesliga,31,1993,1.5,0,0,0,0,0,0,2,0.0,2,0,0,0,2,2,7,0,Jerome RoussillonUnion Berlin
Lazio,Nicolo Rovella,2267,it ITA,MF,it Serie A,22,2001,30.2,84,50,39,38,7,41,79,51.9,38,19,4,15,47,131,46,3,Nicolo RovellaLazio
Marseille,Jon Rowe,2268,eng ENG,"FW,MF",fr Ligue 1,21,2003,9.0,15,11,5,4,6,6,14,42.9,8,4,1,3,2,17,4,0,Jon RoweMarseille
Napoli,Amir Rrahmani,2269,xk KVX,DF,it Serie A,30,1994,37.8,39,31,19,19,1,16,25,64.0,9,43,26,17,27,66,179,2,Amir RrahmaniNapoli
Fiorentina,Tommaso Rubino,2270,it ITA,MF,it Serie A,17,2006,0.1,0,0,0,0,0,0,1,0.0,1,0,0,0,0,0,0,0,Tommaso RubinoFiorentina
Real Madrid,Antonio Rudiger,2271,de GER,DF,es La Liga,31,1993,25.5,20,13,14,6,0,11,15,73.3,4,22,14,8,9,29,96,1,Antonio RudigerReal Madrid
Atalanta,Matteo Ruggeri,2272,it ITA,DF,it Serie A,22,2002,19.5,39,24,15,14,10,25,39,64.1,14,30,4,26,22,61,50,1,Matteo RuggeriAtalanta
Betis,Aitor Ruibal,2273,es ESP,"DF,FW",es La Liga,28,1996,14.6,32,23,22,4,6,25,47,53.2,22,20,5,15,14,46,40,1,Aitor RuibalBetis
Girona,Abel Ruiz,2274,es ESP,FW,es La Liga,24,2000,15.0,6,2,2,2,2,2,5,40.0,3,7,2,5,5,11,7,0,Abel RuizGirona
Girona,Ferran Ruiz,2275,es ESP,MF,es La Liga,21,2003,0.2,0,0,0,0,0,0,0,,0,2,1,1,1,1,0,0,Ferran RuizGirona
Paris S-G,Fabian Ruiz Pena,2276,es ESP,MF,fr Ligue 1,28,1996,21.4,37,24,13,15,9,21,47,44.7,26,25,3,22,16,53,27,1,Fabian Ruiz PenaParis S-G
Marseille,Geronimo Rulli,2277,ar ARG,GK,fr Ligue 1,32,1992,34.0,4,3,4,0,0,4,8,50.0,4,1,0,1,1,5,25,3,Geronimo RulliMarseille
Brighton,Georginio Rutter,2278,fr FRA,"MF,FW",eng Premier League,22,2002,18.4,39,15,13,18,8,14,36,38.9,22,20,3,17,10,49,13,2,Georginio RutterBrighton
Lens,Mathew Ryan,2279,au AUS,GK,fr Ligue 1,32,1992,14.0,1,0,1,0,0,1,2,50.0,1,0,0,0,1,2,2,2,Mathew RyanLens
Dortmund,Julian Ryerson,2280,no NOR,DF,de Bundesliga,26,1997,25.1,46,30,26,13,7,25,44,56.8,19,29,2,27,22,68,26,1,Julian RyersonDortmund
Union Berlin,Frederik Ronnow,2281,dk DEN,GK,de Bundesliga,31,1992,28.0,0,0,0,0,0,0,1,0.0,1,0,0,0,0,0,22,2,Frederik RonnowUnion Berlin
Wolves,Jose Sa,2282,pt POR,GK,eng Premier League,31,1993,29.0,2,2,2,0,0,2,2,100.0,0,0,0,0,0,2,15,1,Jose SaWolves
St. Pauli,Elias Saad,2283,tn TUN,"FW,MF",de Bundesliga,24,1999,10.0,20,13,7,8,5,10,20,50.0,10,14,0,14,3,23,1,0,Elias SaadSt. Pauli
Betis,Youssouf Sabaly,2284,sn SEN,DF,es La Liga,31,1993,17.6,40,25,21,15,4,24,32,75.0,8,21,4,17,13,53,40,0,Youssouf SabalyBetis
Le Havre,Emmanuel Sabbi,2285,us USA,"FW,MF",fr Ligue 1,26,1997,7.3,14,7,7,4,3,5,8,62.5,3,2,0,2,3,17,4,0,Emmanuel SabbiLe Havre
Genoa,Stefano Sabelli,2286,it ITA,DF,it Serie A,31,1993,22.9,58,31,27,25,6,20,52,38.5,32,28,7,21,22,80,65,0,Stefano SabelliGenoa
Dortmund,Marcel Sabitzer,2287,at AUT,MF,de Bundesliga,30,1994,18.0,29,19,7,15,7,16,27,59.3,11,19,6,13,10,39,29,1,Marcel SabitzerDortmund
Montpellier,Falaye Sacko,2288,ml MLI,DF,fr Ligue 1,29,1995,13.7,14,8,9,4,1,9,19,47.4,10,17,7,10,13,27,21,0,Falaye SackoMontpellier
Valencia,Umar Sadiq,2289,ng NGA,FW,es La Liga,27,1997,9.2,10,5,3,5,2,4,6,66.7,2,7,0,7,1,11,7,0,Umar SadiqValencia
Real Sociedad,Umar Sadiq,2290,ng NGA,FW,es La Liga,27,1997,2.5,2,1,1,1,0,1,2,50.0,1,3,1,2,1,3,2,0,Umar SadiqReal Sociedad
Roma,Alexis Saelemaekers,2291,be BEL,"DF,FW",it Serie A,25,1999,15.4,33,20,22,7,4,18,35,51.4,17,12,1,11,9,42,8,1,Alexis SaelemaekersRoma
Milan,Alexis Saelemaekers,2292,be BEL,"DF,FW",it Serie A,25,1999,1.0,1,1,0,0,1,1,1,100.0,0,0,0,0,1,2,0,0,Alexis SaelemaekersMilan
Leganes,Jorge Saenz,2293,es ESP,DF,es La Liga,27,1996,18.8,37,23,18,18,1,11,20,55.0,9,26,17,9,25,62,161,0,Jorge SaenzLeganes
Paris S-G,Matvei Safonov,2294,ru RUS,GK,fr Ligue 1,25,1999,9.8,0,0,0,0,0,0,0,,0,1,0,1,1,1,3,0,Matvei SafonovParis S-G
Montpellier,Modibo Sagnan,2295,ml MLI,DF,fr Ligue 1,25,1999,23.8,57,35,38,16,3,26,44,59.1,18,24,13,11,29,86,110,5,Modibo SagnanMontpellier
Venezia,Richie Sagrado,2296,be BEL,DF,it Serie A,20,2004,1.6,2,2,1,1,0,1,1,100.0,0,1,0,1,3,5,4,0,Richie SagradoVenezia
Lille,Osame Sahraoui,2297,ma MAR,"FW,MF",fr Ligue 1,23,2001,14.4,13,9,4,4,5,3,8,37.5,5,14,1,13,7,20,8,1,Osame SahraouiLille
Lens,Wesley Said,2298,fr FRA,FW,fr Ligue 1,29,1995,10.1,16,11,3,10,3,6,13,46.2,7,6,0,6,2,18,2,0,Wesley SaidLens
Montpellier,Theo Sainte-Luce,2299,fr FRA,DF,fr Ligue 1,25,1998,11.3,24,11,16,4,4,16,33,48.5,17,16,4,12,12,36,33,1,Theo Sainte-LuceMontpellier
Arsenal,Bukayo Saka,2300,eng ENG,"FW,MF",eng Premier League,22,2001,19.2,29,15,9,11,9,13,24,54.2,11,22,0,22,3,32,8,0,Bukayo SakaArsenal
RB Leipzig,Faik Sakar,2301,de GER,MF,de Bundesliga,16,2008,0.0,0,0,0,0,0,0,0,,0,0,0,0,0,0,0,0,Faik SakarRB Leipzig
Como,Marco Sala,2302,it ITA,DF,it Serie A,25,1999,2.9,9,6,5,3,1,5,8,62.5,3,2,0,2,1,10,9,0,Marco SalaComo
Lecce,Marco Sala,2303,it ITA,DF,it Serie A,25,1999,0.8,1,0,0,1,0,0,1,0.0,1,1,0,1,0,1,0,0,Marco SalaLecce
Brest,Ibrahim Salah,2304,ma MAR,FW,fr Ligue 1,22,2001,4.0,4,2,1,1,2,1,6,16.7,5,2,0,2,2,6,0,0,Ibrahim SalahBrest
Liverpool,Mohamed Salah,2305,eg EGY,FW,eng Premier League,32,1992,37.5,21,11,7,5,9,8,17,47.1,9,12,0,12,9,30,5,0,Mohamed SalahLiverpool
Roma,Anass Salah-Eddine,2306,nl NED,DF,it Serie A,22,2002,1.7,1,1,1,0,0,0,0,,0,0,0,0,1,2,2,2,Anass Salah-EddineRoma
Reims,Amine Salama,2307,fr FRA,FW,fr Ligue 1,24,2000,4.1,3,2,0,2,1,0,3,0.0,3,2,1,1,1,4,0,0,Amine SalamaReims
Mallorca,Jan Salas,2308,es ESP,"MF,FW",es La Liga,18,2005,0.5,3,1,2,1,0,2,2,100.0,0,0,0,0,0,3,0,0,Jan SalasMallorca
Sevilla,Kike Salas,2309,es ESP,DF,es La Liga,22,2002,24.9,47,28,24,16,7,27,46,58.7,19,26,14,12,32,79,146,0,Kike SalasSevilla
St. Pauli,Manolis Saliakas,2310,gr GRE,"MF,DF",de Bundesliga,27,1996,25.7,46,22,24,18,4,25,49,51.0,24,38,8,30,20,66,62,0,Manolis SaliakasSt. Pauli
Arsenal,William Saliba,2311,fr FRA,DF,eng Premier League,23,2001,33.8,62,37,37,23,2,21,28,75.0,7,25,15,10,21,83,119,7,William SalibaArsenal
Monaco,Mohammed Salisu,2312,gh GHA,DF,fr Ligue 1,25,1999,11.4,28,18,16,11,1,13,16,81.3,3,10,8,2,16,44,54,2,Mohammed SalisuMonaco
Freiburg,Roland Sallai,2313,hu HUN,"FW,MF",de Bundesliga,27,1997,0.5,2,1,1,1,0,0,0,,0,0,0,0,1,3,0,0,Roland SallaiFreiburg
Le Havre,Yoann Salmier,2314,gf GUF,DF,fr Ligue 1,31,1992,8.9,14,7,9,4,1,10,13,76.9,3,12,8,4,10,24,59,0,Yoann SalmierLe Havre
Atalanta,Lazar Samardzic,2315,rs SRB,MF,it Serie A,22,2002,13.0,21,15,5,7,9,12,25,48.0,13,9,1,8,2,23,6,0,Lazar SamardzicAtalanta
Hoffenheim,Diadie Samassekou,2316,ml MLI,MF,de Bundesliga,28,1996,3.2,5,5,1,2,2,2,4,50.0,2,4,2,2,5,10,5,0,Diadie SamassekouHoffenheim
Lyon,Mama Samba Balde,2317,gw GNB,FW,fr Ligue 1,28,1995,0.4,2,2,0,2,0,0,0,,0,0,0,0,1,3,1,0,Mama Samba BaldeLyon
Brest,Mama Samba Balde,2318,gw GNB,FW,fr Ligue 1,28,1995,12.8,13,9,4,4,5,3,14,21.4,11,8,0,8,6,19,14,0,Mama Samba BaldeBrest
Rennes,Brice Samba,2319,fr FRA,GK,fr Ligue 1,30,1994,17.0,2,1,2,0,0,1,2,50.0,1,0,0,0,0,2,12,3,Brice SambaRennes
Lens,Brice Samba,2320,fr FRA,GK,fr Ligue 1,30,1994,15.0,0,0,0,0,0,0,0,,0,0,0,0,1,1,6,2,Brice SambaLens
Sevilla,Albert Sambi Lokonga,2321,be BEL,MF,es La Liga,24,1999,16.3,22,15,10,9,3,10,14,71.4,4,13,1,12,9,31,24,3,Albert Sambi LokongaSevilla
Empoli,Junior Sambia,2322,fr FRA,"DF,FW",it Serie A,27,1996,4.3,14,10,3,6,5,11,11,100.0,0,3,0,3,2,16,5,0,Junior SambiaEmpoli
Valladolid,Chuky san jose,2323,es ESP,MF,es La Liga,20,2004,8.1,8,2,3,3,2,2,9,22.2,7,4,1,3,0,8,4,0,Chuky san joseValladolid
Torino,Antonio Sanabria,2324,py PAR,FW,it Serie A,28,1996,14.6,3,3,1,1,1,1,4,25.0,3,6,1,5,1,4,13,0,Antonio SanabriaTorino
Athletic Club,Oihan Sancet,2325,es ESP,MF,es La Liga,24,2000,18.0,13,8,6,6,1,5,14,35.7,9,10,0,10,5,18,6,0,Oihan SancetAthletic Club
Udinese,Alexis Sanchez,2326,cl CHI,FW,it Serie A,35,1988,4.9,3,1,0,2,1,1,7,14.3,6,5,0,5,4,7,1,1,Alexis SanchezUdinese
Mallorca,Antonio Sanchez,2327,es ESP,"MF,DF",es La Liga,27,1997,15.5,28,16,16,8,4,14,36,38.9,22,16,2,14,18,46,36,1,Antonio SanchezMallorca
Valladolid,Ivan Sanchez,2328,es ESP,"MF,FW",es La Liga,31,1992,15.6,37,20,18,10,9,12,27,44.4,15,18,3,15,14,51,10,0,Ivan SanchezValladolid
Valladolid,Javi Sanchez,2329,es ESP,DF,es La Liga,27,1997,22.5,26,16,19,6,1,17,26,65.4,9,39,28,11,22,48,111,3,Javi SanchezValladolid
Sevilla,Juanlu Sanchez,2330,es ESP,"MF,DF",es La Liga,20,2003,19.1,50,34,28,15,7,35,59,59.3,24,27,2,25,17,67,19,0,Juanlu SanchezSevilla
Alaves,Manu Sanchez,2331,es ESP,DF,es La Liga,23,2000,29.3,83,56,40,33,10,41,69,59.4,28,51,12,39,30,113,76,1,Manu SanchezAlaves
Chelsea,Robert Sanchez,2332,es ESP,GK,eng Premier League,26,1997,32.0,0,0,0,0,0,0,1,0.0,1,0,0,0,2,2,24,10,Robert SanchezChelsea
Chelsea,Jadon Sancho,2333,eng ENG,FW,eng Premier League,24,2000,19.6,13,7,3,3,7,5,12,41.7,7,11,0,11,2,15,8,2,Jadon SanchoChelsea
Gladbach,Philipp Sander,2334,de GER,MF,de Bundesliga,26,1998,15.6,33,17,16,15,2,10,23,43.5,13,16,7,9,23,56,44,3,Philipp SanderGladbach
St. Pauli,James Sands,2335,us USA,"MF,DF",de Bundesliga,24,2000,5.0,15,6,5,8,2,4,4,100.0,0,5,1,4,5,20,8,0,James SandsSt. Pauli
Bayern Munich,Leroy Sane,2336,de GER,FW,de Bundesliga,28,1996,18.2,23,15,4,8,11,12,23,52.2,11,8,0,8,7,30,3,0,Leroy SaneBayern Munich
Le Havre,Arouna Sangante,2337,sn SEN,DF,fr Ligue 1,22,2002,13.8,25,16,11,14,0,10,17,58.8,7,11,5,6,21,46,65,3,Arouna SanganteLe Havre
Nott'ham Forest,Ibrahim Sangare,2338,ci CIV,MF,eng Premier League,26,1997,6.6,28,14,8,17,3,8,17,47.1,9,10,4,6,6,34,13,1,Ibrahim SangareNott'ham Forest
Reims,Nhoa Sangui,2339,fr FRA,"DF,MF",fr Ligue 1,18,2006,12.9,16,9,6,6,4,9,12,75.0,3,8,4,4,8,24,23,0,Nhoa SanguiReims
Athletic Club,Maroan Sannadi,2340,ma MAR,FW,es La Liga,23,2001,8.4,5,0,1,4,0,2,7,28.6,5,1,0,1,1,6,2,1,Maroan SannadiAthletic Club
Mainz 05,Kaishu Sano,2341,jp JPN,MF,de Bundesliga,23,2000,33.8,61,36,22,31,8,25,52,48.1,27,66,14,52,65,126,56,1,Kaishu SanoMainz 05
Nice,Morgan Sanson,2342,fr FRA,MF,fr Ligue 1,29,1994,2.6,6,3,2,4,0,1,3,33.3,2,3,0,3,4,10,2,0,Morgan SansonNice
Lecce,Nicola Sansone,2343,it ITA,"MF,FW",it Serie A,32,1991,0.7,0,0,0,0,0,0,0,,0,0,0,0,0,0,0,0,Nicola SansoneLecce
Nice,Baptiste Santamaria,2344,fr FRA,MF,fr Ligue 1,29,1995,10.3,20,10,10,7,3,13,22,59.1,9,14,3,11,18,38,19,1,Baptiste SantamariaNice
Rennes,Baptiste Santamaria,2345,fr FRA,MF,fr Ligue 1,29,1995,5.4,11,4,7,3,1,6,11,54.5,5,10,4,6,12,23,7,0,Baptiste SantamariaRennes
Getafe,Jesus Santiago,2346,es ESP,MF,es La Liga,20,2004,4.1,14,8,6,8,0,5,10,50.0,5,6,2,4,1,15,3,0,Jesus SantiagoGetafe
Strasbourg,Andrey Santos,2347,br BRA,MF,fr Ligue 1,20,2004,31.7,110,74,47,51,12,51,87,58.6,36,46,14,32,32,142,67,1,Andrey SantosStrasbourg
Eint Frankfurt,Kaua Santos,2348,br BRA,GK,de Bundesliga,21,2003,8.5,0,0,0,0,0,0,0,,0,0,0,0,0,0,10,2,Kaua SantosEint Frankfurt
Lille,Tiago Santos,2349,pt POR,DF,fr Ligue 1,22,2002,4.5,12,7,4,5,3,6,9,66.7,3,2,0,2,2,14,4,0,Tiago SantosLille
Wolves,Pablo Sarabia,2350,es ESP,"MF,FW",eng Premier League,32,1992,9.0,16,8,4,8,4,10,16,62.5,6,10,0,10,4,20,7,1,Pablo SarabiaWolves
Brighton,Jeremy Sarmiento,2351,ec ECU,MF,eng Premier League,22,2002,0.1,0,0,0,0,0,0,0,,0,0,0,0,0,0,0,0,Jeremy SarmientoBrighton
Hellas Verona,Amin Sarr,2352,se SWE,FW,it Serie A,23,2001,21.2,22,12,3,8,11,5,10,50.0,5,18,3,15,3,25,14,0,Amin SarrHellas Verona
Crystal Palace,Ismaila Sarr,2353,sn SEN,MF,eng Premier League,26,1998,30.1,22,10,10,9,3,8,25,32.0,17,27,8,19,9,31,40,0,Ismaila SarrCrystal Palace
Lens,Malang Sarr,2354,fr FRA,DF,fr Ligue 1,25,1999,15.4,21,13,12,6,3,16,27,59.3,11,18,9,9,22,43,63,3,Malang SarrLens
Strasbourg,Mamadou Sarr,2355,fr FRA,DF,fr Ligue 1,18,2005,26.3,37,21,24,11,2,16,24,66.7,8,26,20,6,25,62,117,3,Mamadou SarrStrasbourg
Lens,Martin Satriano,2356,uy URU,"FW,DF",fr Ligue 1,23,2001,1.0,3,1,1,1,1,3,3,100.0,0,0,0,0,0,3,2,0,Martin SatrianoLens
Udinese,Razvan Sava,2357,ro ROU,GK,it Serie A,22,2002,12.0,0,0,0,0,0,0,0,,0,0,0,0,0,0,6,2,Razvan SavaUdinese
Montpellier,Teji Savanier,2358,fr FRA,MF,fr Ligue 1,32,1991,26.3,29,25,7,16,6,18,43,41.9,25,16,1,15,15,44,21,4,Teji SavanierMontpellier
Manchester City,Savio,2359,br BRA,"FW,MF",eng Premier League,20,2004,19.6,23,17,5,10,8,10,19,52.6,9,14,2,12,6,29,9,1,SavioManchester City
Juventus,Nicolo Savona,2360,it ITA,DF,it Serie A,21,2003,19.2,29,13,19,9,1,13,25,52.0,12,12,3,9,11,40,38,0,Nicolo SavonaJuventus
Torino,Saba Sazonov,2361,ge GEO,DF,it Serie A,22,2002,0.0,0,0,0,0,0,0,0,,0,1,1,0,0,0,0,0,Saba SazonovTorino
Gladbach,Joe Scally,2362,us USA,DF,de Bundesliga,21,2002,28.6,45,32,25,18,2,27,46,58.7,19,35,11,24,16,61,86,2,Joe ScallyGladbach
Atalanta,Giorgio Scalvini,2363,it ITA,DF,it Serie A,20,2003,3.0,8,4,5,3,0,5,9,55.6,4,0,0,0,4,12,7,0,Giorgio ScalviniAtalanta
Atalanta,Gianluca Scamacca,2364,it ITA,FW,it Serie A,25,1999,0.1,0,0,0,0,0,0,0,,0,0,0,0,0,0,0,0,Gianluca ScamaccaAtalanta
West Ham,Oliver Scarles,2365,eng ENG,"DF,FW",eng Premier League,18,2005,7.4,21,11,17,3,1,14,22,63.6,8,14,2,12,11,32,26,0,Oliver ScarlesWest Ham
Tottenham,Dane Scarlett,2366,eng ENG,"FW,MF",eng Premier League,20,2004,0.4,1,0,0,1,0,0,0,,0,0,0,0,0,1,1,0,Dane ScarlettTottenham
Brentford,Kevin Schade,2367,de GER,FW,eng Premier League,22,2001,25.5,39,25,17,10,12,13,23,56.5,10,19,4,15,5,44,34,0,Kevin SchadeBrentford
Union Berlin,Andras Schafer,2368,hu HUN,MF,de Bundesliga,25,1999,17.0,52,26,23,24,5,25,41,61.0,16,33,6,27,22,74,36,0,Andras SchaferUnion Berlin
Newcastle Utd,Fabian Schar,2369,ch SUI,DF,eng Premier League,32,1991,32.6,36,21,16,18,2,14,35,40.0,21,38,25,13,45,81,138,3,Fabian ScharNewcastle Utd
Leverkusen,Patrik Schick,2370,cz CZE,FW,de Bundesliga,28,1996,18.7,6,5,1,3,2,1,5,20.0,4,9,1,8,4,10,17,1,Patrik SchickLeverkusen
Heidenheim,Stefan Schimmer,2371,de GER,"FW,MF",de Bundesliga,30,1994,2.7,2,0,1,1,0,1,2,50.0,1,1,0,1,0,2,4,0,Stefan SchimmerHeidenheim
Venezia,Joel Schingtienne,2372,be BEL,DF,it Serie A,21,2002,12.5,27,16,18,7,2,12,19,63.2,7,18,9,9,14,41,25,5,Joel SchingtienneVenezia
RB Leipzig,Xaver Schlager,2373,at AUT,MF,de Bundesliga,26,1997,2.0,4,2,2,1,1,3,7,42.9,4,7,0,7,0,4,3,0,Xaver SchlagerRB Leipzig
Augsburg,Keven Schlotterbeck,2374,de GER,DF,de Bundesliga,27,1997,14.4,19,17,9,9,1,12,16,75.0,4,13,6,7,15,34,73,1,Keven SchlotterbeckAugsburg
Dortmund,Nico Schlotterbeck,2375,de GER,DF,de Bundesliga,24,1999,22.0,38,24,21,16,1,27,45,60.0,18,31,15,16,22,60,79,1,Nico SchlotterbeckDortmund
Crystal Palace,Jeffrey Schlupp,2376,gh GHA,"MF,DF",eng Premier League,31,1992,1.1,2,0,1,0,1,0,3,0.0,3,6,0,6,0,2,2,0,Jeffrey SchluppCrystal Palace
Werder Bremen,Romano Schmid,2377,at AUT,MF,de Bundesliga,24,2000,31.5,43,25,10,22,11,24,51,47.1,27,42,3,39,11,54,9,2,Romano SchmidWerder Bremen
Toulouse,Niklas Schmidt,2378,de GER,MF,fr Ligue 1,26,1998,2.3,6,4,1,5,0,4,7,57.1,3,0,0,0,1,7,4,0,Niklas SchmidtToulouse
Heidenheim,Jan Schoppner,2379,de GER,MF,de Bundesliga,25,1999,29.8,56,30,19,27,10,20,58,34.5,38,38,6,32,43,99,95,1,Jan SchoppnerHeidenheim
Holstein Kiel,Marvin Schulz,2380,de GER,"MF,DF",de Bundesliga,29,1995,3.4,6,5,2,2,2,2,8,25.0,6,12,8,4,0,6,17,0,Marvin SchulzHolstein Kiel
Union Berlin,Alexander Schwolow,2381,de GER,GK,de Bundesliga,32,1992,6.0,0,0,0,0,0,0,0,,0,0,0,0,0,0,2,1,Alexander SchwolowUnion Berlin
Heidenheim,Leo Scienza,2382,br BRA,"FW,MF",de Bundesliga,25,1998,12.8,17,12,10,5,2,7,18,38.9,11,13,1,12,5,22,9,1,Leo ScienzaHeidenheim
Bournemouth,Alex Scott,2383,eng ENG,MF,eng Premier League,20,2003,8.4,27,14,11,8,8,19,42,45.2,23,17,4,13,10,37,15,0,Alex ScottBournemouth
Cagliari,Simone Scuffet,2384,it ITA,GK,it Serie A,28,1996,13.0,0,0,0,0,0,0,1,0.0,1,0,0,0,0,0,8,2,Simone ScuffetCagliari
Napoli,Simone Scuffet,2385,it ITA,GK,it Serie A,28,1996,1.0,0,0,0,0,0,0,0,,0,0,0,0,0,0,2,0,Simone ScuffetNapoli
Strasbourg,Jeremy Sebas,2386,mq MTQ,"FW,MF",fr Ligue 1,21,2003,2.1,3,2,1,1,1,2,3,66.7,1,2,0,2,0,3,4,0,Jeremy SebasStrasbourg
Alaves,Aleksandar Sedlar,2387,rs SRB,DF,es La Liga,32,1991,6.6,18,10,7,11,0,8,10,80.0,2,2,1,1,10,28,24,1,Aleksandar SedlarAlaves
Empoli,Jacopo Seghetti,2388,it ITA,GK,it Serie A,19,2005,1.0,0,0,0,0,0,0,0,,0,0,0,0,0,0,0,0,Jacopo SeghettiEmpoli
Rennes,Alidu Seidu,2389,gh GHA,DF,fr Ligue 1,24,2000,8.9,22,18,14,6,2,12,15,80.0,3,13,6,7,14,36,17,0,Alidu SeiduRennes
RB Leipzig,Nicolas Seiwald,2390,at AUT,"MF,DF",de Bundesliga,23,2001,23.2,53,31,19,29,5,25,50,50.0,25,43,10,33,31,84,76,2,Nicolas SeiwaldRB Leipzig
Reims,Hiroki Sekine,2391,jp JPN,DF,fr Ligue 1,21,2002,9.9,9,7,6,2,1,7,17,41.2,10,22,11,11,5,14,51,1,Hiroki SekineReims
Nott'ham Forest,Matz Sels,2392,be BEL,GK,eng Premier League,32,1992,38.0,1,1,1,0,0,1,1,100.0,0,0,0,0,0,1,26,1,Matz SelsNott'ham Forest
Wolves,Nelson Semedo,2393,pt POR,DF,eng Premier League,30,1993,32.1,62,36,32,21,9,34,57,59.6,23,32,10,22,23,85,104,3,Nelson SemedoWolves
Bournemouth,Antoine Semenyo,2394,gh GHA,FW,eng Premier League,24,2000,35.6,55,35,17,25,13,16,43,37.2,27,67,9,58,11,66,39,2,Antoine SemenyoBournemouth
Strasbourg,Marvin Senaya,2395,tg TOG,DF,fr Ligue 1,23,2001,2.5,8,3,5,2,1,6,12,50.0,6,6,2,4,7,15,12,0,Marvin SenayaStrasbourg
Bournemouth,Marcos Senesi,2396,ar ARG,DF,eng Premier League,27,1997,12.3,39,21,23,14,2,14,31,45.2,17,16,7,9,14,53,58,0,Marcos SenesiBournemouth
Monza,Stefano Sensi,2397,it ITA,MF,it Serie A,28,1995,3.0,8,5,4,4,0,5,6,83.3,1,4,2,2,3,11,3,1,Stefano SensiMonza
Hellas Verona,Suat Serdar,2398,de GER,MF,it Serie A,27,1997,15.3,35,22,12,19,4,10,26,38.5,16,19,4,15,8,43,21,0,Suat SerdarHellas Verona
Leganes,Sergi,2399,es ESP,DF,es La Liga,32,1992,32.9,40,29,22,16,2,18,32,56.3,14,38,29,9,39,79,185,2,SergiLeganes
Athletic Club,Nicolas Serrano,2400,es ESP,FW,es La Liga,21,2003,1.2,1,1,0,1,0,1,3,33.3,2,4,0,4,1,2,1,0,Nicolas SerranoAthletic Club
RB Leipzig,Benjamin Sesko,2401,si SVN,"FW,MF",de Bundesliga,21,2003,26.4,7,3,0,4,3,3,11,27.3,8,15,4,11,5,12,20,0,Benjamin SeskoRB Leipzig
Fulham,Ryan Sessegnon,2402,eng ENG,"FW,DF",eng Premier League,24,2000,6.4,27,13,11,11,5,9,20,45.0,11,13,1,12,3,30,18,0,Ryan SessegnonFulham
Roma,Stephan El Shaarawy,2403,it ITA,"DF,MF",it Serie A,31,1992,12.2,16,12,4,6,6,6,12,50.0,6,4,0,4,10,26,13,0,Stephan El ShaarawyRoma
Manchester Utd,Luke Shaw,2404,eng ENG,DF,eng Premier League,29,1995,3.9,4,3,2,2,0,2,2,100.0,0,6,1,5,2,6,7,0,Luke ShawManchester Utd
Cagliari,Alen Sherri,2405,al ALB,GK,it Serie A,26,1997,6.9,1,0,1,0,0,1,2,50.0,1,0,0,0,1,2,1,0,Alen SherriCagliari
Roma,Eldor Shomurodov,2406,uz UZB,"FW,MF",it Serie A,29,1995,12.2,14,6,2,7,5,3,6,50.0,3,10,1,9,3,17,5,0,Eldor ShomurodovRoma
Toulouse,Djibril Sidibe,2407,fr FRA,DF,fr Ligue 1,32,1992,23.3,65,36,34,22,9,31,50,62.0,19,11,3,8,20,85,64,1,Djibril SidibeToulouse
Mainz 05,Armindo Sieb,2408,de GER,"FW,MF",de Bundesliga,21,2003,8.5,10,4,4,5,1,3,10,30.0,7,4,0,4,1,11,7,0,Armindo SiebMainz 05
Genoa,Benjamin Siegrist,2409,ch SUI,GK,it Serie A,32,1992,1.7,0,0,0,0,0,0,0,,0,0,0,0,1,1,1,0,Benjamin SiegristGenoa
Toulouse,Vincent Sierro,2410,ch SUI,MF,fr Ligue 1,28,1995,26.7,44,27,15,23,6,27,56,48.2,29,34,9,25,16,60,44,1,Vincent SierroToulouse
Heidenheim,Tim Siersleben,2411,de GER,DF,de Bundesliga,24,2000,13.1,21,14,12,8,1,7,17,41.2,10,19,6,13,20,41,66,0,Tim SierslebenHeidenheim
Bournemouth,Zain Silcott-Duberry,2412,ms MSR,FW,eng Premier League,19,2005,0.0,1,1,0,0,1,1,1,100.0,0,0,0,0,0,1,0,0,Zain Silcott-DuberryBournemouth
Freiburg,Kiliann Sildillia,2413,fr FRA,DF,de Bundesliga,22,2002,8.9,17,10,8,6,3,7,13,53.8,6,16,5,11,11,28,38,0,Kiliann SildilliaFreiburg
Werder Bremen,Andre Silva,2414,pt POR,FW,de Bundesliga,28,1995,4.2,2,2,1,1,0,0,1,0.0,1,3,1,2,0,2,3,0,Andre SilvaWerder Bremen
RB Leipzig,Andre Silva,2415,pt POR,"FW,MF",de Bundesliga,28,1995,1.5,1,1,1,0,0,0,1,0.0,1,1,0,1,1,2,2,0,Andre SilvaRB Leipzig
Manchester City,Bernardo Silva,2416,pt POR,"MF,FW",eng Premier League,29,1994,29.7,56,37,17,30,9,25,56,44.6,31,36,7,29,23,79,32,3,Bernardo SilvaManchester City
Monaco,Caio Henrique Oliveira Silva,2417,br BRA,DF,fr Ligue 1,27,1997,21.4,37,26,16,19,2,23,44,52.3,21,26,8,18,22,59,59,0,Caio Henrique Oliveira SilvaMonaco
Las Palmas,Fabio Silva,2418,pt POR,FW,es La Liga,22,2002,20.7,12,7,4,5,3,4,14,28.6,10,12,0,12,4,16,27,0,Fabio SilvaLas Palmas
Nott'ham Forest,Jota Silva,2419,pt POR,"FW,MF",eng Premier League,24,1999,9.5,27,14,12,13,2,6,27,22.2,21,9,1,8,12,39,17,0,Jota SilvaNott'ham Forest
Nott'ham Forest,Eric da Silva Moreira,2420,de GER,"MF,DF",eng Premier League,18,2006,0.3,2,2,2,0,0,2,6,33.3,4,0,0,0,1,3,0,0,Eric da Silva MoreiraNott'ham Forest
Betis,Rui Silva,2421,pt POR,GK,es La Liga,30,1994,15.0,0,0,0,0,0,0,1,0.0,1,1,0,1,0,0,7,0,Rui SilvaBetis
Empoli,Marco Silvestri,2422,it ITA,GK,it Serie A,33,1991,5.0,0,0,0,0,0,0,2,0.0,2,0,0,0,0,0,3,1,Marco SilvestriEmpoli
Brest,Abdallah Sima,2423,sn SEN,"FW,MF",fr Ligue 1,23,2001,13.8,15,11,2,5,8,4,11,36.4,7,9,1,8,1,16,9,0,Abdallah SimaBrest
RB Leipzig,Mohamed Simakan,2424,fr FRA,DF,de Bundesliga,24,2000,0.6,0,0,0,0,0,0,0,,0,0,0,0,2,2,0,0,Mohamed SimakanRB Leipzig
Napoli,Giovanni Simeone,2425,ar ARG,FW,it Serie A,29,1995,4.7,2,0,0,1,1,1,6,16.7,5,9,2,7,1,3,6,0,Giovanni SimeoneNapoli
Atletico Madrid,Giuliano Simeone,2426,ar ARG,MF,es La Liga,21,2002,21.4,27,13,6,11,10,15,30,50.0,15,22,3,19,14,41,22,1,Giuliano SimeoneAtletico Madrid
Nantes,Moses Simon,2427,ng NGA,"FW,MF",fr Ligue 1,29,1995,29.0,20,14,4,7,9,7,22,31.8,15,11,0,11,12,32,13,0,Moses SimonNantes
Athletic Club,Unai Simon,2428,es ESP,GK,es La Liga,27,1997,21.0,0,0,0,0,0,0,0,,0,1,0,1,1,1,14,4,Unai SimonAthletic Club
RB Leipzig,Xavi Simons,2429,nl NED,MF,de Bundesliga,21,2003,23.9,28,21,5,15,8,12,26,46.2,14,19,3,16,12,40,19,1,Xavi SimonsRB Leipzig
Manchester City,Jahmai Simpson-Pusey,2430,eng ENG,DF,eng Premier League,18,2005,1.1,1,0,1,0,0,0,1,0.0,1,1,1,0,0,1,2,0,Jahmai Simpson-PuseyManchester City
St. Pauli,Danel Sinani,2431,lu LUX,"FW,MF",de Bundesliga,27,1997,13.9,14,11,2,7,5,6,14,42.9,8,12,1,11,1,15,13,0,Danel SinaniSt. Pauli
Auxerre,Lassine Sinayoko,2432,ml MLI,"FW,MF",fr Ligue 1,24,1999,25.5,33,20,10,14,9,11,23,47.8,12,16,2,14,13,46,38,0,Lassine SinayokoAuxerre
Monaco,Wilfried Singo,2433,ci CIV,DF,fr Ligue 1,23,2000,23.3,37,23,24,10,3,20,28,71.4,8,17,9,8,43,80,110,2,Wilfried SingoMonaco
Bournemouth,Luis Sinisterra,2434,co COL,"FW,MF",eng Premier League,25,1999,2.6,7,2,3,2,2,0,4,0.0,4,3,0,3,1,8,8,0,Luis SinisterraBournemouth
Las Palmas,Daley Sinkgraven,2435,nl NED,DF,es La Liga,29,1995,1.0,5,1,3,2,0,1,3,33.3,2,1,0,1,1,6,2,0,Daley SinkgravenLas Palmas
Gladbach,Tobias Sippel,2436,de GER,GK,de Bundesliga,36,1988,0.7,0,0,0,0,0,0,0,,0,0,0,0,0,0,0,0,Tobias SippelGladbach
Celta Vigo,Jailson Siqueira,2437,br BRA,"DF,MF",es La Liga,28,1995,6.8,13,11,9,3,1,9,11,81.8,2,6,4,2,9,22,28,1,Jailson SiqueiraCelta Vigo
Rennes,Ayanda Sishuba,2438,be BEL,FW,fr Ligue 1,19,2005,0.0,1,0,1,0,0,1,1,100.0,0,0,0,0,0,1,0,0,Ayanda SishubaRennes
Saint-Etienne,Ibrahim Sissoko,2439,ml MLI,FW,fr Ligue 1,28,1995,9.1,11,9,5,3,3,2,5,40.0,3,10,2,8,2,13,13,0,Ibrahim SissokoSaint-Etienne
Bochum,Ibrahima Sissoko,2440,ml MLI,MF,de Bundesliga,26,1997,29.0,66,44,30,31,5,24,45,53.3,21,39,11,28,36,102,61,0,Ibrahima SissokoBochum
Reims,Niama Sissoko,2441,ml MLI,"FW,MF",fr Ligue 1,18,2005,0.5,0,0,0,0,0,0,0,,0,1,0,1,0,0,0,0,Niama SissokoReims
Alaves,Antonio Sivera,2442,es ESP,GK,es La Liga,27,1996,31.2,2,1,2,0,0,2,2,100.0,0,1,0,1,0,2,20,0,Antonio SiveraAlaves
Union Berlin,Tim Skarke,2443,de GER,"FW,MF",de Bundesliga,27,1996,12.9,14,11,5,8,1,10,19,52.6,9,7,0,7,5,19,17,0,Tim SkarkeUnion Berlin
Eint Frankfurt,Ellyes Skhiri,2444,tn TUN,MF,de Bundesliga,29,1995,24.8,40,22,15,21,4,18,44,40.9,26,30,7,23,31,71,45,4,Ellyes SkhiriEint Frankfurt
Leicester City,Oliver Skipp,2445,eng ENG,MF,eng Premier League,23,2000,12.5,21,4,6,12,3,9,15,60.0,6,23,7,16,11,32,11,2,Oliver SkippLeicester City
Rennes,Leo Skiri Ostigard,2446,no NOR,DF,fr Ligue 1,24,1999,13.6,20,18,16,4,0,15,22,68.2,7,12,10,2,15,35,81,1,Leo Skiri OstigardRennes
Hoffenheim,Leo Skiri Ostigard,2447,no NOR,DF,de Bundesliga,24,1999,10.3,9,7,5,4,0,4,6,66.7,2,17,9,8,9,18,111,0,Leo Skiri OstigardHoffenheim
Bologna,Lukasz Skorupski,2448,pl POL,GK,it Serie A,33,1991,26.3,1,0,1,0,0,1,3,33.3,2,0,0,0,0,1,13,2,Lukasz SkorupskiBologna
Wolfsburg,Andreas Skov Olsen,2449,dk DEN,"FW,MF",de Bundesliga,24,1999,5.9,8,6,5,3,0,4,4,100.0,0,4,0,4,2,10,12,0,Andreas Skov OlsenWolfsburg
Union Berlin,Robert Skov,2450,dk DEN,"DF,MF",de Bundesliga,28,1996,9.5,15,11,8,7,0,10,20,50.0,10,8,1,7,8,23,9,0,Robert SkovUnion Berlin
Paris S-G,Milan Skriniar,2451,sk SVK,DF,fr Ligue 1,29,1995,4.2,7,5,3,4,0,3,3,100.0,0,7,6,1,3,10,16,0,Milan SkriniarParis S-G
Holstein Kiel,Steven Skrzybski,2452,de GER,"MF,FW",de Bundesliga,31,1992,14.7,19,6,7,6,6,7,24,29.2,17,16,0,16,11,30,11,0,Steven SkrzybskiHolstein Kiel
Toulouse,Naatan Skytta,2453,fi FIN,FW,fr Ligue 1,22,2002,0.1,1,0,0,0,1,0,0,,0,0,0,0,0,1,0,0,Naatan SkyttaToulouse
Southampton,William Smallbone,2454,ie IRL,MF,eng Premier League,24,2000,7.7,20,13,9,9,2,7,22,31.8,15,8,0,8,2,22,14,2,William SmallboneSouthampton
Bournemouth,Adam Smith,2455,eng ENG,DF,eng Premier League,33,1991,17.7,24,12,11,7,6,14,27,51.9,13,13,5,8,15,39,49,1,Adam SmithBournemouth
St. Pauli,Eric Smith,2456,se SWE,"DF,MF",de Bundesliga,27,1997,31.4,46,29,26,17,3,23,40,57.5,17,37,10,27,37,83,104,4,Eric SmithSt. Pauli
Espanyol,Justin Smith,2457,ca CAN,MF,es La Liga,21,2003,2.3,9,3,3,6,0,4,6,66.7,2,5,1,4,4,13,3,0,Justin SmithEspanyol
Fulham,Emile Smith Rowe,2458,eng ENG,MF,eng Premier League,24,2000,22.7,31,18,7,14,10,8,24,33.3,16,22,2,20,11,42,16,0,Emile Smith RoweFulham
Como,Ivan Smolcic,2459,hr CRO,DF,it Serie A,23,2000,7.0,16,9,8,7,1,9,13,69.2,4,8,2,6,10,26,24,0,Ivan SmolcicComo
Strasbourg,Eduard Sobol,2460,ua UKR,DF,fr Ligue 1,29,1995,1.1,0,0,0,0,0,0,2,0.0,2,2,1,1,2,2,14,0,Eduard SobolStrasbourg
Parma,Simon Sohm,2461,ch SUI,MF,it Serie A,23,2001,33.2,28,17,11,13,4,16,35,45.7,19,11,3,8,26,54,36,0,Simon SohmParma
Getafe,Alex Sola,2462,es ESP,"MF,FW",es La Liga,25,1999,11.4,21,14,9,12,0,9,25,36.0,16,8,0,8,7,28,11,1,Alex SolaGetafe
Villarreal,Arnau Sola,2463,es ESP,MF,es La Liga,21,2003,0.1,0,0,0,0,0,0,2,0.0,2,1,1,0,0,0,0,0,Arnau SolaVillarreal
Tottenham,Dominic Solanke,2464,eng ENG,FW,eng Premier League,26,1997,24.5,18,11,1,12,5,4,16,25.0,12,20,9,11,1,19,23,0,Dominic SolankeTottenham
Empoli,Ola Solbakken,2465,no NOR,"MF,FW",it Serie A,25,1998,8.4,7,4,0,6,1,3,6,50.0,3,0,0,0,2,9,8,0,Ola SolbakkenEmpoli
West Ham,Carlos Soler,2466,es ESP,"MF,FW",eng Premier League,27,1997,15.7,16,11,9,6,1,7,23,30.4,16,19,6,13,8,24,21,2,Carlos SolerWest Ham
Bournemouth,Julio Soler,2467,ar ARG,"DF,FW",eng Premier League,19,2005,0.1,1,1,1,0,0,1,1,100.0,0,1,0,1,0,1,0,0,Julio SolerBournemouth
Udinese,Oumar Solet,2468,fr FRA,DF,it Serie A,24,2000,18.6,33,19,18,13,2,21,30,70.0,9,32,19,13,17,50,78,4,Oumar SoletUdinese
Girona,Jhon Solis,2469,co COL,MF,es La Liga,19,2004,5.9,13,7,3,9,1,6,14,42.9,8,13,1,12,4,17,6,1,Jhon SolisGirona
Genoa,Daniele Sommariva,2470,it ITA,GK,it Serie A,27,1997,0.3,0,0,0,0,0,0,0,,0,0,0,0,0,0,1,0,Daniele SommarivaGenoa
Inter,Yann Sommer,2471,ch SUI,GK,it Serie A,35,1988,32.0,0,0,0,0,0,0,0,,0,0,0,0,0,0,13,1,Yann SommerInter
Getafe,David Soria,2472,es ESP,GK,es La Liga,31,1993,38.0,4,4,4,0,0,4,5,80.0,1,0,0,0,1,5,21,3,David SoriaGetafe
Leganes,Juan Soriano,2473,es ESP,GK,es La Liga,26,1997,6.0,1,1,1,0,0,1,1,100.0,0,0,0,0,0,1,2,0,Juan SorianoLeganes
Torino,Borna Sosa,2474,hr CRO,DF,it Serie A,26,1998,13.1,26,19,14,7,5,16,25,64.0,9,13,6,7,14,40,33,0,Borna SosaTorino
Nott'ham Forest,Ramon Sosa,2475,py PAR,"FW,MF",eng Premier League,24,1999,3.3,5,3,3,0,2,1,5,20.0,4,9,0,9,4,9,5,0,Ramon SosaNott'ham Forest
Celta Vigo,Hugo Sotelo,2476,es ESP,MF,es La Liga,20,2003,13.9,28,17,8,10,10,13,31,41.9,18,9,1,8,5,33,9,1,Hugo SoteloCelta Vigo
Lens,Florian Sotoca,2477,fr FRA,"FW,MF",fr Ligue 1,33,1990,19.9,22,13,3,8,11,12,22,54.5,10,12,2,10,14,36,25,0,Florian SotocaLens
Fiorentina,Riccardo Sottil,2478,it ITA,"FW,MF",it Serie A,25,1999,9.3,5,4,3,1,1,3,4,75.0,1,1,0,1,4,9,3,0,Riccardo SottilFiorentina
Milan,Riccardo Sottil,2479,it ITA,"FW,MF",it Serie A,25,1999,1.4,1,1,1,0,0,0,0,,0,0,0,0,0,1,0,0,Riccardo SottilMilan
West Ham,Tomas Soucek,2480,cz CZE,MF,eng Premier League,29,1995,28.5,46,21,20,23,3,26,44,59.1,18,41,21,20,20,66,85,1,Tomas SoucekWest Ham
Roma,Matias Soule,2481,ar ARG,"MF,DF",it Serie A,21,2003,19.8,26,16,12,7,7,10,23,43.5,13,25,3,22,9,35,25,0,Matias SouleRoma
Leicester City,Boubakary Soumare,2482,fr FRA,MF,eng Premier League,25,1999,24.1,37,20,24,12,1,21,33,63.6,12,22,10,12,27,64,34,4,Boubakary SoumareLeicester City
Le Havre,Issa Soumare,2483,sn SEN,"FW,MF",fr Ligue 1,23,2000,21.1,25,14,8,10,7,13,49,26.5,36,19,4,15,16,41,32,0,Issa SoumareLe Havre
Sevilla,Djibril Sow,2484,ch SUI,MF,es La Liga,27,1997,22.9,25,14,13,10,2,8,17,47.1,9,18,3,15,28,53,26,1,Djibril SowSevilla
Strasbourg,Saidou Sow,2485,gn GUI,DF,fr Ligue 1,22,2002,11.3,9,5,6,3,0,6,12,50.0,6,15,9,6,15,24,37,2,Saidou SowStrasbourg
Nantes,Saidou Sow,2486,gn GUI,DF,fr Ligue 1,22,2002,8.9,17,11,13,4,0,6,10,60.0,4,19,12,7,13,30,46,1,Saidou SowNantes
Tottenham,Djed Spence,2487,eng ENG,DF,eng Premier League,23,2000,19.9,47,34,25,15,7,23,30,76.7,7,28,9,19,21,68,74,2,Djed SpenceTottenham
Napoli,Leonardo Spinazzola,2488,it ITA,"DF,FW",it Serie A,31,1993,16.9,17,10,6,9,2,10,23,43.5,13,12,1,11,9,26,31,1,Leonardo SpinazzolaNapoli
Milan,Marco Sportiello,2489,it ITA,GK,it Serie A,32,1992,1.4,0,0,0,0,0,0,0,,0,0,0,0,0,0,1,0,Marco SportielloMilan
Hoffenheim,Anton Stach,2490,de GER,"MF,DF",de Bundesliga,25,1998,28.7,66,46,25,37,4,32,47,68.1,15,47,13,34,46,112,101,2,Anton StachHoffenheim
Werder Bremen,Jens Stage,2491,dk DEN,MF,de Bundesliga,27,1996,24.5,49,30,22,24,3,25,46,54.3,21,44,10,34,18,67,42,2,Jens StageWerder Bremen
Bayern Munich,Josip Stanisic,2492,hr CRO,DF,de Bundesliga,24,2000,9.7,13,11,6,4,3,7,15,46.7,8,10,6,4,6,19,29,1,Josip StanisicBayern Munich
Venezia,Filip Stankovic,2493,rs SRB,GK,it Serie A,22,2002,15.2,0,0,0,0,0,0,0,,0,0,0,0,0,0,11,2,Filip StankovicVenezia
Fulham,Jay Stansfield,2494,eng ENG,MF,eng Premier League,21,2002,0.0,0,0,0,0,0,0,0,,0,0,0,0,0,0,0,0,Jay StansfieldFulham
Celta Vigo,Carl Starfelt,2495,se SWE,DF,es La Liga,29,1995,25.2,40,20,25,14,1,18,27,66.7,9,29,21,8,31,71,129,3,Carl StarfeltCelta Vigo
Werder Bremen,Niklas Stark,2496,de GER,DF,de Bundesliga,29,1995,23.4,33,21,20,11,2,14,21,66.7,7,41,27,14,36,69,129,1,Niklas StarkWerder Bremen
Saint-Etienne,Lucas Stassin,2497,be BEL,FW,fr Ligue 1,19,2004,21.0,16,11,3,5,8,6,20,30.0,14,10,0,10,3,19,8,0,Lucas StassinSaint-Etienne
Brighton,Jason Steele,2498,eng ENG,GK,eng Premier League,33,1990,2.0,0,0,0,0,0,0,0,,0,0,0,0,0,0,1,0,Jason SteeleBrighton
Real Sociedad,Orri Steinn Oskarsson,2499,is ISL,FW,es La Liga,19,2004,10.5,6,6,2,1,3,2,8,25.0,6,10,1,9,2,8,11,0,Orri Steinn OskarssonReal Sociedad
Stuttgart,Pascal Stenzel,2500,de GER,DF,de Bundesliga,28,1996,3.2,3,2,1,0,2,2,5,40.0,3,5,1,4,2,5,6,0,Pascal StenzelStuttgart
Southampton,Jack Stephens,2501,eng ENG,DF,eng Premier League,30,1994,15.4,34,20,25,9,0,17,30,56.7,13,20,13,7,13,47,53,2,Jack StephensSouthampton
Stuttgart,Leonidas Stergiou,2502,ch SUI,DF,de Bundesliga,22,2002,9.5,24,13,9,11,4,16,19,84.2,3,16,5,11,14,38,39,0,Leonidas StergiouStuttgart
Arsenal,Raheem Sterling,2503,eng ENG,"FW,MF",eng Premier League,29,1994,5.5,9,4,1,3,5,5,10,50.0,5,3,0,3,1,10,4,0,Raheem SterlingArsenal
Marseille,Enzo Sternal,2504,fr FRA,"FW,MF",fr Ligue 1,17,2007,0.3,0,0,0,0,0,0,0,,0,0,0,0,0,0,0,0,Enzo SternalMarseille
St. Pauli,Finley Stevens,2505,wls WAL,DF,de Bundesliga,21,2003,0.0,0,0,0,0,0,0,0,,0,0,0,0,0,0,0,0,Finley StevensSt. Pauli
Southampton,Ross Stewart,2506,sct SCO,FW,eng Premier League,28,1996,4.3,6,4,1,1,4,3,8,37.5,5,3,0,3,1,7,7,0,Ross StewartSouthampton
Stuttgart,Angelo Stiller,2507,de GER,MF,de Bundesliga,23,2001,30.5,49,27,18,25,6,14,30,46.7,16,29,9,20,26,75,50,4,Angelo StillerStuttgart
Gladbach,Kevin Stoger,2508,at AUT,MF,de Bundesliga,30,1993,17.2,37,21,23,10,4,16,39,41.0,23,24,3,21,16,53,26,3,Kevin StogerGladbach
Alaves,Stoichkov,2509,es ESP,"MF,FW",es La Liga,30,1993,7.8,14,9,6,7,1,6,11,54.5,5,2,0,2,1,15,7,0,StoichkovAlaves
Empoli,Petar Stojanovic,2510,si SVN,MF,it Serie A,28,1995,0.0,0,0,0,0,0,0,0,,0,0,0,0,0,0,0,0,Petar StojanovicEmpoli
Leicester City,Jakub Stolarczyk,2511,pl POL,GK,eng Premier League,23,2000,10.0,2,1,2,0,0,1,2,50.0,1,0,0,0,0,2,6,1,Jakub StolarczykLeicester City
Manchester City,John Stones,2512,eng ENG,"DF,MF",eng Premier League,30,1994,6.1,6,2,3,2,1,5,5,100.0,0,5,3,2,4,10,19,1,John StonesManchester City
Wolves,Jorgen Strand Larsen,2513,no NOR,FW,eng Premier League,24,2000,28.7,10,6,2,3,5,4,27,14.8,23,19,4,15,6,16,29,0,Jorgen Strand LarsenWolves
Como,Gabriel Strefezza,2514,br BRA,"FW,MF",it Serie A,27,1997,29.1,57,39,20,20,17,21,55,38.2,34,24,2,22,13,70,26,0,Gabriel StrefezzaComo
Girona,Cristhian Stuani,2515,uy URU,FW,es La Liga,37,1986,12.0,9,7,1,7,1,5,8,62.5,3,4,1,3,7,16,11,0,Cristhian StuaniGirona
Las Palmas,Alex Suarez,2516,es ESP,DF,es La Liga,31,1993,27.3,40,23,30,9,1,20,27,74.1,7,39,24,15,13,53,107,2,Alex SuarezLas Palmas
Villarreal,Denis Suarez,2517,es ESP,MF,es La Liga,30,1994,6.8,12,8,7,2,3,4,10,40.0,6,4,1,3,3,15,3,0,Denis SuarezVillarreal
Toulouse,Gabriel Suazo,2518,cl CHI,DF,fr Ligue 1,26,1997,24.0,59,39,25,22,12,30,72,41.7,42,27,3,24,36,95,40,1,Gabriel SuazoToulouse
Real Sociedad,Luka Sucic,2519,hr CRO,MF,es La Liga,21,2002,19.9,25,18,8,12,5,10,26,38.5,16,30,2,28,15,40,16,1,Luka SucicReal Sociedad
Southampton,Yukinari Sugawara,2520,jp JPN,"DF,MF",eng Premier League,24,2000,17.3,31,18,16,14,1,19,31,61.3,12,21,10,11,11,42,53,3,Yukinari SugawaraSouthampton
Dortmund,Niklas Sule,2521,de GER,DF,de Bundesliga,28,1995,11.7,14,12,9,5,0,10,14,71.4,4,11,6,5,4,18,46,1,Niklas SuleDortmund
Atalanta,Ibrahim Sulemana,2522,gh GHA,MF,it Serie A,21,2003,3.1,9,4,4,5,0,2,8,25.0,6,2,0,2,0,9,1,0,Ibrahim SulemanaAtalanta
Southampton,Kamaldeen Sulemana,2523,gh GHA,"FW,MF",eng Premier League,22,2002,15.6,22,17,9,5,8,10,15,66.7,5,16,4,12,6,28,9,0,Kamaldeen SulemanaSouthampton
West Ham,Crysencio Summerville,2524,nl NED,"FW,MF",eng Premier League,22,2001,8.7,13,7,2,8,3,3,9,33.3,6,13,4,9,0,13,7,0,Crysencio SummervilleWest Ham
Hellas Verona,Tomas Suslov,2525,sk SVK,"MF,FW",it Serie A,22,2002,23.1,54,38,23,24,7,23,72,31.9,49,30,2,28,18,72,17,1,Tomas SuslovHellas Verona
Sevilla,Suso,2526,es ESP,"FW,MF",es La Liga,30,1993,6.7,10,7,3,6,1,4,11,36.4,7,4,0,4,4,14,2,0,SusoSevilla
Parma,Zion Suzuki,2527,jp JPN,GK,it Serie A,21,2002,36.8,1,0,1,0,0,1,2,50.0,1,0,0,0,0,1,35,4,Zion SuzukiParma
Wolfsburg,Mattias Svanberg,2528,se SWE,MF,de Bundesliga,25,1999,13.5,20,10,6,11,3,9,19,47.4,10,11,4,7,15,35,26,0,Mattias SvanbergWolfsburg
Dortmund,Daniel Svensson,2529,se SWE,"DF,FW",de Bundesliga,22,2002,8.7,15,11,5,6,4,7,11,63.6,4,10,4,6,5,20,30,0,Daniel SvenssonDortmund
Venezia,Marin Sverko,2530,hr CRO,DF,it Serie A,26,1998,12.4,20,9,14,6,0,10,12,83.3,2,10,5,5,16,36,45,3,Marin SverkoVenezia
Roma,Mile Svilar,2531,rs SRB,GK,it Serie A,24,1999,38.0,0,0,0,0,0,0,0,,0,0,0,0,0,0,12,2,Mile SvilarRoma
Venezia,Michael Svoboda,2532,at AUT,DF,it Serie A,25,1998,14.6,26,14,19,6,1,8,19,42.1,11,19,11,8,22,48,66,2,Michael SvobodaVenezia
Celta Vigo,Williot Swedberg,2533,se SWE,"FW,MF",es La Liga,20,2004,15.0,23,16,9,10,4,13,20,65.0,7,12,1,11,3,26,10,1,Williot SwedbergCelta Vigo
Strasbourg,Abakar Sylla,2534,ci CIV,DF,fr Ligue 1,21,2002,10.6,27,15,14,11,2,15,17,88.2,2,18,10,8,11,38,63,0,Abakar SyllaStrasbourg
Montpellier,Issiaga Sylla,2535,gn GUI,DF,fr Ligue 1,30,1994,12.8,25,10,17,7,1,15,29,51.7,14,13,4,9,10,35,34,1,Issiaga SyllaMontpellier
Valladolid,Mamadou Sylla,2536,sn SEN,"FW,MF",es La Liga,30,1994,17.6,8,4,3,3,2,2,9,22.2,7,8,0,8,3,11,14,1,Mamadou SyllaValladolid
Barcelona,Wojciech Szczesny,2537,pl POL,GK,es La Liga,34,1990,15.0,1,1,1,0,0,0,0,,0,0,0,0,0,1,20,1,Wojciech SzczesnyBarcelona
Ipswich Town,Sammie Szmodics,2538,ie IRL,"FW,MF",eng Premier League,28,1995,11.0,16,10,4,10,2,7,26,26.9,19,10,2,8,6,22,14,0,Sammie SzmodicsIpswich Town
Liverpool,Dominik Szoboszlai,2539,hu HUN,MF,eng Premier League,23,2000,27.7,38,20,14,19,5,17,45,37.8,28,39,5,34,9,47,19,2,Dominik SzoboszlaiLiverpool
Atletico Madrid,Alexander Sorloth,2540,no NOR,FW,es La Liga,28,1995,17.4,9,5,2,5,2,3,6,50.0,3,6,1,5,1,10,28,0,Alexander SorlothAtletico Madrid
Montpellier,Musa Al-Taamari,2541,jo JOR,"FW,MF",fr Ligue 1,27,1997,12.4,14,10,4,5,5,8,15,53.3,7,2,0,2,3,17,3,2,Musa Al-TaamariMontpellier
Rennes,Musa Al-Taamari,2542,jo JOR,"FW,MF",fr Ligue 1,27,1997,6.3,4,1,1,1,2,0,4,0.0,4,5,0,5,2,6,2,0,Musa Al-TaamariRennes
Hoffenheim,Haris Tabakovic,2543,ba BIH,FW,de Bundesliga,30,1994,9.1,3,1,1,0,2,0,3,0.0,3,4,2,2,1,4,16,0,Haris TabakovicHoffenheim
Lyon,Nicolas Tagliafico,2544,ar ARG,DF,fr Ligue 1,31,1992,21.1,57,37,24,22,11,29,48,60.4,19,25,7,18,36,93,55,0,Nicolas TagliaficoLyon
Leverkusen,Jonathan Tah,2545,de GER,DF,de Bundesliga,28,1996,33.0,19,12,12,6,1,10,16,62.5,6,22,16,6,36,55,157,2,Jonathan TahLeverkusen
Torino,Adrien Tameze,2546,cm CMR,"MF,DF",it Serie A,30,1994,7.2,5,2,2,3,0,1,10,10.0,9,8,5,3,10,15,8,1,Adrien TamezeTorino
Paris S-G,Axel Tape,2547,fr FRA,"DF,MF",fr Ligue 1,16,2007,2.0,3,1,1,2,0,2,2,100.0,0,2,2,0,1,4,5,0,Axel TapeParis S-G
Leganes,Renato Tapia,2548,pe PER,"MF,DF",es La Liga,29,1995,26.9,61,35,30,27,4,24,50,48.0,26,58,23,35,27,88,86,2,Renato TapiaLeganes
Leverkusen,Edmond Tapsoba,2549,bf BFA,DF,de Bundesliga,25,1999,27.9,39,24,19,16,4,22,39,56.4,17,21,14,7,24,63,89,3,Edmond TapsobaLeverkusen
Saint-Etienne,Florian Tardieu,2550,fr FRA,MF,fr Ligue 1,32,1992,13.9,18,14,6,9,3,6,17,35.3,11,18,5,13,15,33,21,0,Florian TardieuSaint-Etienne
Inter,Mehdi Taremi,2551,ir IRN,FW,it Serie A,32,1992,9.0,7,1,2,2,3,1,4,25.0,3,11,2,9,0,7,11,0,Mehdi TaremiInter
Newcastle Utd,Matt Targett,2552,eng ENG,DF,eng Premier League,28,1995,0.2,0,0,0,0,0,0,1,0.0,1,0,0,0,1,1,1,0,Matt TargettNewcastle Utd
Le Havre,Oussama Targhalline,2553,ma MAR,MF,fr Ligue 1,22,2002,11.0,19,14,12,3,4,5,12,41.7,7,14,7,7,19,38,14,2,Oussama TarghallineLe Havre
Everton,James Tarkowski,2554,eng ENG,DF,eng Premier League,31,1992,32.5,64,40,39,22,3,24,39,61.5,15,57,42,15,41,105,213,4,James TarkowskiEverton
Valencia,Cesar Tarrega,2555,es ESP,DF,es La Liga,22,2002,33.6,49,37,33,13,3,19,31,61.3,12,41,20,21,22,71,222,2,Cesar TarregaValencia
Lazio,Nuno Tavares,2556,pt POR,DF,it Serie A,24,2000,18.7,28,21,15,8,5,14,34,41.2,20,21,3,18,21,49,44,2,Nuno TavaresLazio
Bournemouth,Marcus Tavernier,2557,eng ENG,"FW,MF",eng Premier League,25,1999,21.5,43,24,15,19,9,10,27,37.0,17,16,3,13,5,48,11,0,Marcus TavernierBournemouth
Southampton,Charlie Taylor,2558,eng ENG,DF,eng Premier League,30,1993,4.0,7,5,4,3,0,5,7,71.4,2,8,5,3,5,12,31,1,Charlie TaylorSouthampton
Ipswich Town,Jack Taylor,2559,ie IRL,MF,eng Premier League,26,1998,9.6,20,10,6,11,3,12,27,44.4,15,12,3,9,9,29,24,0,Jack TaylorIpswich Town
Lazio,Loum Tchaouna,2560,fr FRA,"FW,MF",it Serie A,20,2003,7.3,8,4,2,2,4,3,9,33.3,6,5,1,4,4,12,14,2,Loum TchaounaLazio
Hellas Verona,Jackson Tchatchoua,2561,cm CMR,"DF,MF",it Serie A,22,2001,35.2,50,31,34,13,3,28,43,65.1,15,21,9,12,14,64,75,2,Jackson TchatchouaHellas Verona
Montpellier,Enzo Tchato,2562,cm CMR,DF,fr Ligue 1,21,2002,21.1,48,26,26,18,4,26,44,59.1,18,30,10,20,22,70,59,0,Enzo TchatoMontpellier
Real Madrid,Aurelien Tchouameni,2563,fr FRA,"DF,MF",es La Liga,24,2000,29.9,47,23,25,19,3,21,41,51.2,20,34,25,9,46,93,92,1,Aurelien TchouameniReal Madrid
Espanyol,Alvaro Tejero,2564,es ESP,"MF,DF",es La Liga,28,1996,13.8,14,4,7,6,1,7,23,30.4,16,9,1,8,13,27,34,1,Alvaro TejeroEspanyol
Valencia,Martin Tejon,2565,es ESP,"MF,DF",es La Liga,20,2004,0.5,2,0,0,2,0,1,2,50.0,1,0,0,0,0,2,0,0,Martin TejonValencia
Tottenham,Mathys Tel,2566,fr FRA,FW,eng Premier League,19,2005,10.1,16,6,5,6,5,5,13,38.5,8,8,1,7,2,18,8,2,Mathys TelTottenham
Bayern Munich,Mathys Tel,2567,fr FRA,"FW,MF",de Bundesliga,19,2005,2.8,2,2,0,2,0,0,0,,0,0,0,0,1,3,1,0,Mathys TelBayern Munich
Leverkusen,Nathan Tella,2568,ng NGA,"MF,FW",de Bundesliga,25,1999,15.1,16,11,4,7,5,5,13,38.5,8,15,1,14,4,20,10,0,Nathan TellaLeverkusen
Alaves,Nahuel Tenaglia,2569,ar ARG,DF,es La Liga,28,1996,32.5,96,61,61,30,5,53,88,60.2,35,33,9,24,47,143,123,2,Nahuel TenagliaAlaves
Paris S-G,Arnau Tenas,2570,es ESP,GK,fr Ligue 1,23,2001,1.0,0,0,0,0,0,0,0,,0,0,0,0,0,0,0,0,Arnau TenasParis S-G
Hellas Verona,Casper Tengstedt,2571,dk DEN,FW,it Serie A,24,2000,16.9,7,5,0,5,2,4,9,44.4,5,5,1,4,4,11,29,0,Casper TengstedtHellas Verona
Barcelona,Marc-Andre ter Stegen,2572,de GER,GK,es La Liga,32,1992,7.5,0,0,0,0,0,0,1,0.0,1,0,0,0,0,0,2,2,Marc-Andre ter StegenBarcelona
Milan,Filippo Terracciano,2573,it ITA,"DF,MF",it Serie A,21,2003,6.0,9,6,1,6,2,5,10,50.0,5,1,0,1,6,15,11,0,Filippo TerraccianoMilan
Fiorentina,Pietro Terracciano,2574,it ITA,GK,it Serie A,34,1990,3.0,0,0,0,0,0,0,0,,0,0,0,0,0,0,0,0,Pietro TerraccianoFiorentina
Villarreal,Ramon Terrats,2575,es ESP,"MF,FW",es La Liga,23,2000,1.5,3,3,1,2,0,2,4,50.0,2,3,1,2,2,5,3,0,Ramon TerratsVillarreal
Getafe,Ramon Terrats,2576,es ESP,"MF,FW",es La Liga,23,2000,13.5,20,10,7,8,5,8,28,28.6,20,9,2,7,8,28,16,0,Ramon TerratsGetafe
Leverkusen,Martin Terrier,2577,fr FRA,"MF,FW",de Bundesliga,27,1997,6.5,4,2,1,0,3,1,4,25.0,3,3,0,3,1,5,1,0,Martin TerrierLeverkusen
Lyon,Tanner Tessmann,2578,us USA,MF,fr Ligue 1,22,2001,13.7,25,15,11,10,4,12,25,48.0,13,13,7,6,19,44,29,1,Tanner TessmannLyon
Fulham,Kenny Tete,2579,nl NED,DF,eng Premier League,28,1995,19.7,56,38,29,14,13,23,38,60.5,15,31,12,19,32,88,67,0,Kenny TeteFulham
Reims,Teddy Teuma,2580,mt MLT,MF,fr Ligue 1,30,1993,8.3,18,10,6,6,6,7,25,28.0,18,12,2,10,12,30,8,1,Teddy TeumaReims
Monaco,Jordan Teze,2581,nl NED,DF,fr Ligue 1,24,1999,6.3,18,9,8,9,1,7,16,43.8,9,12,1,11,6,24,15,0,Jordan TezeMonaco
Udinese,Florian Thauvin,2582,fr FRA,"FW,MF",it Serie A,31,1993,21.7,20,14,9,8,3,10,25,40.0,15,6,0,6,7,27,10,0,Florian ThauvinUdinese
Eint Frankfurt,Arthur Theate,2583,be BEL,DF,de Bundesliga,24,2000,30.0,36,25,19,16,1,22,44,50.0,22,42,19,23,39,75,170,3,Arthur TheateEint Frankfurt
Heidenheim,Norman Theuerkauf,2584,de GER,MF,de Bundesliga,37,1987,0.2,0,0,0,0,0,0,0,,0,0,0,0,0,0,0,0,Norman TheuerkaufHeidenheim
Brentford,Thiago,2585,br BRA,"FW,MF",eng Premier League,23,2001,1.9,5,3,2,1,2,0,1,0.0,1,3,0,3,2,7,3,1,ThiagoBrentford
Milan,Malick Thiaw,2586,de GER,DF,it Serie A,22,2001,20.1,24,17,15,6,3,6,10,60.0,4,14,12,2,15,39,76,1,Malick ThiawMilan
Heidenheim,Denis Thomalla,2587,de GER,MF,de Bundesliga,31,1992,0.0,0,0,0,0,0,0,0,,0,0,0,0,0,0,0,0,Denis ThomallaHeidenheim
Leicester City,Luke Thomas,2588,eng ENG,DF,eng Premier League,23,2001,12.3,31,25,23,5,3,21,41,51.2,20,15,6,9,21,52,49,1,Luke ThomasLeicester City
Nantes,Sorba Thomas,2589,wls WAL,"FW,MF",fr Ligue 1,24,1999,14.7,14,6,7,5,2,10,18,55.6,8,12,2,10,9,23,27,1,Sorba ThomasNantes
Lens,Adrien Thomasson,2590,fr FRA,MF,fr Ligue 1,30,1993,29.1,90,47,42,25,23,52,95,54.7,43,48,3,45,19,109,28,2,Adrien ThomassonLens
Genoa,Morten Thorsby,2591,no NOR,"MF,FW",it Serie A,28,1996,21.1,49,30,19,20,10,17,29,58.6,12,22,1,21,5,54,28,1,Morten ThorsbyGenoa
Juventus,Khephren Thuram,2592,fr FRA,MF,it Serie A,23,2001,25.8,44,21,16,24,4,18,32,56.3,14,32,10,22,14,58,39,2,Khephren ThuramJuventus
Inter,Marcus Thuram,2593,fr FRA,FW,it Serie A,26,1997,24.4,18,8,7,5,6,3,14,21.4,11,16,3,13,3,21,15,0,Marcus ThuramInter
Hellas Verona,Cheikh Tidiane Niasse,2594,sn SEN,MF,it Serie A,24,2000,8.4,18,15,6,12,0,10,19,52.6,9,17,4,13,17,35,17,2,Cheikh Tidiane NiasseHellas Verona
Aston Villa,Youri Tielemans,2595,be BEL,MF,eng Premier League,27,1997,33.6,84,58,32,44,8,40,73,54.8,33,38,16,22,23,107,47,4,Youri TielemansAston Villa
Arsenal,Kieran Tierney,2596,sct SCO,"DF,FW",eng Premier League,27,1997,2.9,7,5,4,1,2,4,6,66.7,2,0,0,0,3,10,9,0,Kieran TierneyArsenal
Augsburg,Phillip Tietz,2597,de GER,FW,de Bundesliga,27,1997,18.7,11,6,2,7,2,5,8,62.5,3,10,1,9,5,16,26,1,Phillip TietzAugsburg
Arsenal,Jurrien Timber,2598,nl NED,DF,eng Premier League,23,2001,26.9,58,38,17,30,11,18,27,66.7,9,19,4,15,22,80,44,1,Jurrien TimberArsenal
West Ham,Jean-Clair Todibo,2599,fr FRA,DF,eng Premier League,24,1999,20.3,47,28,30,15,2,26,36,72.2,10,25,13,12,26,73,83,3,Jean-Clair TodiboWest Ham
Nott'ham Forest,Harry Toffolo,2600,eng ENG,DF,eng Premier League,28,1995,1.5,5,3,3,1,1,3,4,75.0,1,2,2,0,2,7,12,0,Harry ToffoloNott'ham Forest
Hoffenheim,Umut Tohumcu,2601,de GER,"MF,FW",de Bundesliga,19,2004,4.2,9,5,3,5,1,5,7,71.4,2,5,0,5,3,12,6,0,Umut TohumcuHoffenheim
Lyon,Corentin Tolisso,2602,fr FRA,MF,fr Ligue 1,29,1994,25.9,57,25,21,26,10,34,65,52.3,31,52,13,39,22,79,41,1,Corentin TolissoLyon
Holstein Kiel,John Tolkin,2603,us USA,"DF,MF",de Bundesliga,22,2002,8.2,18,11,11,7,0,12,14,85.7,2,10,2,8,8,26,54,0,John TolkinHolstein Kiel
Atalanta,Rafael Toloi,2604,it ITA,DF,it Serie A,33,1990,5.2,10,5,3,5,2,4,11,36.4,7,8,2,6,8,18,11,0,Rafael ToloiAtalanta
Rayo Vallecano,Raul de Tomas,2605,es ESP,"DF,FW",es La Liga,29,1994,0.2,2,2,1,0,1,0,0,,0,0,0,0,0,2,0,0,Raul de TomasRayo Vallecano
Wolfsburg,Tiago Tomas,2606,pt POR,"FW,MF",de Bundesliga,22,2002,20.9,33,19,15,11,7,15,35,42.9,20,17,4,13,9,42,19,0,Tiago TomasWolfsburg
Arsenal,Takehiro Tomiyasu,2607,jp JPN,DF,eng Premier League,25,1998,0.1,0,0,0,0,0,0,0,,0,0,0,0,0,0,1,0,Takehiro TomiyasuArsenal
Milan,Fikayo Tomori,2608,eng ENG,DF,it Serie A,26,1997,17.7,40,25,21,16,3,17,25,68.0,8,17,12,5,20,60,61,2,Fikayo TomoriMilan
Newcastle Utd,Sandro Tonali,2609,it ITA,MF,eng Premier League,24,2000,29.2,51,32,22,23,6,25,51,49.0,26,34,11,23,34,85,33,2,Sandro TonaliNewcastle Utd
Inter,Luka Topalovic,2610,si SVN,MF,it Serie A,18,2006,0.1,1,1,0,1,0,0,0,,0,0,0,0,0,1,0,0,Luka TopalovicInter
Barcelona,Pablo Torre,2611,es ESP,"MF,FW",es La Liga,21,2003,3.4,5,4,1,3,1,2,4,50.0,2,0,0,0,3,8,5,1,Pablo TorreBarcelona
Valladolid,David Torres,2612,es ESP,DF,es La Liga,21,2003,15.4,13,8,12,1,0,7,11,63.6,4,19,17,2,10,23,74,0,David TorresValladolid
Barcelona,Ferran Torres,2613,es ESP,"FW,MF",es La Liga,24,2000,12.3,8,4,2,3,3,3,8,37.5,5,7,1,6,4,12,5,0,Ferran TorresBarcelona
Aston Villa,Pau Torres,2614,es ESP,DF,eng Premier League,27,1997,22.4,21,15,11,8,2,10,17,58.8,7,16,11,5,10,31,75,2,Pau TorresAston Villa
Osasuna,Lucas Torro,2615,es ESP,MF,es La Liga,30,1994,32.9,74,41,34,35,5,36,64,56.3,28,36,9,27,45,119,70,3,Lucas TorroOsasuna
Empoli,Lorenzo Tosto,2616,it ITA,DF,it Serie A,18,2006,0.0,0,0,0,0,0,0,0,,0,0,0,0,0,0,0,0,Lorenzo TostoEmpoli
Le Havre,Abdoulaye Toure,2617,gn GUI,MF,fr Ligue 1,30,1994,25.8,61,34,31,21,9,33,59,55.9,26,36,19,17,34,95,42,5,Abdoulaye ToureLe Havre
Hoffenheim,Bazoumana Toure,2618,ci CIV,"FW,MF",de Bundesliga,18,2006,6.8,12,10,2,7,3,2,8,25.0,6,4,0,4,3,15,2,0,Bazoumana ToureHoffenheim
Montpellier,Birama Toure,2619,ml MLI,"MF,DF",fr Ligue 1,32,1992,3.3,8,5,5,2,1,4,6,66.7,2,3,2,1,6,14,7,0,Birama ToureMontpellier
Lille,Ousmane Toure,2620,fr FRA,DF,fr Ligue 1,19,2005,0.1,0,0,0,0,0,0,0,,0,0,0,0,1,1,2,0,Ousmane ToureLille
Udinese,Souleymane Toure,2621,fr FRA,DF,it Serie A,21,2003,8.1,7,6,4,3,0,4,5,80.0,1,15,6,9,9,16,17,1,Souleymane ToureUdinese
Union Berlin,Lucas Tousart,2622,fr FRA,MF,de Bundesliga,27,1997,6.2,17,9,6,9,2,5,12,41.7,7,11,4,7,7,24,27,0,Lucas TousartUnion Berlin
Ipswich Town,Conor Townsend,2623,eng ENG,DF,eng Premier League,31,1993,3.7,11,8,9,2,0,8,11,72.7,3,8,6,2,4,15,16,0,Conor TownsendIpswich Town
Fulham,Adama Traore,2624,es ESP,"FW,MF",eng Premier League,28,1996,19.7,20,13,9,6,5,5,13,38.5,8,7,0,7,1,21,6,4,Adama TraoreFulham
Wolves,Boubacar Traore,2625,ml MLI,MF,eng Premier League,22,2001,0.0,2,0,0,2,0,1,1,100.0,0,0,0,0,0,2,0,0,Boubacar TraoreWolves
Real Sociedad,Hamari Traore,2626,ml MLI,DF,es La Liga,32,1992,7.8,19,12,10,7,2,15,22,68.2,7,6,2,4,9,28,21,0,Hamari TraoreReal Sociedad
Heidenheim,Omar Traore,2627,de GER,DF,de Bundesliga,26,1998,29.1,50,26,31,16,3,25,41,61.0,16,35,6,29,21,71,66,0,Omar TraoreHeidenheim
Eint Frankfurt,Kevin Trapp,2628,de GER,GK,de Bundesliga,34,1990,25.5,0,0,0,0,0,0,0,,0,0,0,0,0,0,13,3,Kevin TrappEint Frankfurt
Bournemouth,Mark Travers,2629,ie IRL,GK,eng Premier League,25,1999,5.0,0,0,0,0,0,0,0,,0,0,0,0,0,0,5,0,Mark TraversBournemouth
Rayo Vallecano,Oscar Trejo,2630,ar ARG,MF,es La Liga,36,1988,5.5,8,5,1,5,2,3,9,33.3,6,9,0,9,4,12,5,0,Oscar TrejoRayo Vallecano
St. Pauli,Philipp Treu,2631,de GER,"MF,DF",de Bundesliga,23,2000,32.0,61,42,35,17,9,39,68,57.4,29,52,12,40,19,80,87,2,Philipp TreuSt. Pauli
Brentford,Ryan Trevitt,2632,eng ENG,MF,eng Premier League,21,2003,0.0,1,1,1,0,0,0,0,,0,0,0,0,0,1,0,0,Ryan TrevittBrentford
Union Berlin,Christopher Trimmel,2633,at AUT,"DF,MF",de Bundesliga,37,1987,19.3,38,25,23,14,1,28,42,66.7,14,14,6,8,18,56,92,0,Christopher TrimmelUnion Berlin
Newcastle Utd,Kieran Trippier,2634,eng ENG,DF,eng Premier League,33,1990,14.5,38,21,18,14,6,22,36,61.1,14,11,3,8,12,50,49,0,Kieran TrippierNewcastle Utd
Arsenal,Leandro Trossard,2635,be BEL,FW,eng Premier League,29,1994,28.3,31,20,6,16,9,12,34,35.3,22,32,0,32,9,40,18,0,Leandro TrossardArsenal
Rennes,Adrien Truffert,2636,fr FRA,"DF,MF",fr Ligue 1,22,2001,30.6,61,36,27,21,13,32,48,66.7,16,44,6,38,27,88,56,1,Adrien TruffertRennes
Liverpool,Kostas Tsimikas,2637,gr GRE,DF,eng Premier League,28,1996,9.3,31,20,15,11,5,14,23,60.9,9,5,2,3,11,42,20,0,Kostas TsimikasLiverpool
Girona,Viktor Tsyhankov,2638,ua UKR,"FW,MF",es La Liga,26,1997,21.3,19,12,4,7,8,9,19,47.4,10,7,1,6,15,34,16,1,Viktor TsyhankovGirona
Ipswich Town,Axel Tuanzebe,2639,cd COD,DF,eng Premier League,26,1997,19.0,31,19,21,4,6,17,26,65.4,9,21,10,11,23,54,56,1,Axel TuanzebeIpswich Town
Monza,Stefano Turati,2640,it ITA,GK,it Serie A,22,2001,29.7,0,0,0,0,0,0,1,0.0,1,0,0,0,0,0,21,2,Stefano TuratiMonza
Real Sociedad,Benat Turrientes,2641,es ESP,MF,es La Liga,22,2002,10.5,15,6,4,10,1,4,15,26.7,11,15,3,12,5,20,14,1,Benat TurrientesReal Sociedad
Eint Frankfurt,Tuta,2642,br BRA,"DF,MF",de Bundesliga,25,1999,25.3,44,27,25,17,2,28,40,70.0,12,42,21,21,40,84,135,1,TutaEint Frankfurt
Getafe,Christantus Uche,2643,ng NGA,"FW,MF",es La Liga,21,2003,27.6,35,21,8,19,8,9,20,45.0,11,20,2,18,10,45,19,0,Christantus UcheGetafe
Tottenham,Destiny Udogie,2644,it ITA,DF,eng Premier League,21,2002,21.4,75,47,42,26,7,33,48,68.8,15,40,6,34,22,97,36,1,Destiny UdogieTottenham
Manchester Utd,Manuel Ugarte Ribeiro,2645,uy URU,MF,eng Premier League,23,2001,19.8,77,49,34,34,9,30,68,44.1,38,33,4,29,27,104,17,2,Manuel Ugarte RibeiroManchester Utd
Southampton,Lesley Ugochukwu,2646,fr FRA,MF,eng Premier League,20,2004,18.4,50,24,16,30,4,18,36,50.0,18,27,10,17,14,64,23,2,Lesley UgochukwuSouthampton
Gladbach,Lukas Ullrich,2647,de GER,DF,de Bundesliga,20,2004,21.1,25,16,18,6,1,15,42,35.7,27,26,9,17,23,48,74,1,Lukas UllrichGladbach
Bayern Munich,Sven Ulreich,2648,de GER,GK,de Bundesliga,35,1988,1.0,0,0,0,0,0,0,0,,0,0,0,0,0,0,0,0,Sven UlreichBayern Munich
Bournemouth,Enes Unal,2649,tr TUR,"FW,MF",eng Premier League,27,1997,3.8,1,0,0,0,1,0,3,0.0,3,1,0,1,0,1,6,0,Enes UnalBournemouth
Stuttgart,Deniz Undav,2650,de GER,"FW,MF",de Bundesliga,28,1996,19.2,11,10,2,3,6,1,17,5.9,16,15,2,13,3,14,10,0,Deniz UndavStuttgart
Espanyol,Naci Unuvar,2651,nl NED,"MF,DF",es La Liga,21,2003,0.3,2,2,1,1,0,1,2,50.0,1,0,0,0,0,2,0,0,Naci UnuvarEspanyol
Bayern Munich,Dayot Upamecano,2652,fr FRA,DF,de Bundesliga,25,1998,19.5,36,22,18,16,2,16,29,55.2,13,17,7,10,34,70,45,1,Dayot UpamecanoBayern Munich
Bologna,Kacper Urbanski,2653,pl POL,MF,it Serie A,19,2004,2.7,5,2,4,0,1,4,6,66.7,2,5,1,4,2,7,5,0,Kacper UrbanskiBologna
Monza,Kacper Urbanski,2654,pl POL,MF,it Serie A,19,2004,5.6,5,3,1,2,2,4,7,57.1,3,7,2,5,2,7,9,0,Kacper UrbanskiMonza
Bayern Munich,Jonas Urbig,2655,de GER,GK,de Bundesliga,20,2003,8.0,0,0,0,0,0,0,0,,0,0,0,0,0,0,9,2,Jonas UrbigBayern Munich
Eint Frankfurt,Can Uzun,2656,tr TUR,"MF,FW",de Bundesliga,18,2005,7.5,10,4,1,4,5,5,10,50.0,5,9,0,9,1,11,3,0,Can UzunEint Frankfurt
Stuttgart,Josha Vagnoman,2657,de GER,"DF,MF",de Bundesliga,23,2000,20.4,26,14,11,13,2,17,34,50.0,17,16,2,14,14,40,57,1,Josha VagnomanStuttgart
Parma,Lautaro Valenti,2658,ar ARG,DF,it Serie A,25,1999,17.3,17,12,13,3,1,7,9,77.8,2,26,13,13,13,30,94,1,Lautaro ValentiParma
Rayo Vallecano,Oscar Valentin,2659,es ESP,MF,es La Liga,29,1994,20.4,55,41,21,20,14,33,76,43.4,43,36,8,28,21,76,51,2,Oscar ValentinRayo Vallecano
Hellas Verona,Nicolas Valentini,2660,ar ARG,DF,it Serie A,23,2001,12.5,35,23,22,12,1,20,31,64.5,11,15,7,8,15,50,97,0,Nicolas ValentiniHellas Verona
Valencia,German Valera,2661,es ESP,MF,es La Liga,22,2002,1.6,1,1,1,0,0,0,1,0.0,1,2,0,2,4,5,2,1,German ValeraValencia
Parma,Emanuele Valeri,2662,it ITA,DF,it Serie A,25,1998,31.9,51,31,33,15,3,30,61,49.2,31,31,10,21,29,80,103,4,Emanuele ValeriParma
Mallorca,Martin Valjent,2663,sk SVK,DF,es La Liga,28,1995,30.7,30,21,22,7,1,15,25,60.0,10,32,21,11,18,48,195,1,Martin ValjentMallorca
Como,Alex Valle,2664,es ESP,DF,it Serie A,20,2004,11.4,26,12,12,12,2,15,21,71.4,6,13,2,11,8,34,42,0,Alex ValleComo
Real Madrid,Jesus Vallejo,2665,es ESP,DF,es La Liga,27,1997,1.5,0,0,0,0,0,0,0,,0,0,0,0,2,2,8,0,Jesus VallejoReal Madrid
Monza,Mattia Valoti,2666,it ITA,MF,it Serie A,30,1993,0.4,3,3,3,0,0,0,2,0.0,2,2,0,2,0,3,2,0,Mattia ValotiMonza
Real Madrid,Federico Valverde,2667,uy URU,"MF,DF",es La Liga,26,1998,33.7,50,30,22,23,5,29,43,67.4,14,38,8,30,55,105,52,1,Federico ValverdeReal Madrid
Como,Ignace Van Der Brempt,2668,be BEL,DF,it Serie A,22,2002,14.0,40,32,27,10,3,24,33,72.7,9,14,5,9,17,57,34,0,Ignace Van Der BremptComo
Mallorca,Siebe Van Der Heyden,2669,be BEL,"DF,MF",es La Liga,26,1998,1.1,1,1,0,1,0,0,0,,0,1,0,1,2,3,3,0,Siebe Van Der HeydenMallorca
St. Pauli,Siebe Van Der Heyden,2670,be BEL,"DF,MF",de Bundesliga,26,1998,9.7,17,10,10,7,0,8,18,44.4,10,8,4,4,17,34,43,2,Siebe Van Der HeydenSt. Pauli
Liverpool,Virgil van Dijk,2671,nl NED,DF,eng Premier League,33,1991,37.0,38,20,17,19,2,13,22,59.1,9,27,16,11,56,94,190,4,Virgil van DijkLiverpool
Monaco,Vanderson,2672,br BRA,DF,fr Ligue 1,23,2001,22.9,76,48,37,30,9,45,64,70.3,19,43,6,37,39,115,65,2,VandersonMonaco
RB Leipzig,Maarten Vandevoordt,2673,be BEL,GK,de Bundesliga,22,2002,4.8,1,0,1,0,0,1,1,100.0,0,0,0,0,0,1,4,0,Maarten VandevoordtRB Leipzig
Leicester City,Jamie Vardy,2674,eng ENG,FW,eng Premier League,37,1987,31.4,19,13,7,7,5,4,13,30.8,9,8,4,4,5,24,24,0,Jamie VardyLeicester City
Sevilla,Ruben Vargas,2675,ch SUI,"FW,MF",es La Liga,25,1998,7.5,7,4,1,5,1,3,8,37.5,5,9,0,9,3,10,10,0,Ruben VargasSevilla
Augsburg,Ruben Vargas,2676,ch SUI,"MF,FW",de Bundesliga,25,1998,3.4,2,1,1,1,0,1,4,25.0,3,1,0,1,2,4,1,1,Ruben VargasAugsburg
St. Pauli,Nikola Vasilj,2677,ba BIH,GK,de Bundesliga,28,1995,33.0,0,0,0,0,0,0,2,0.0,2,0,0,0,0,0,22,3,Nikola VasiljSt. Pauli
Empoli,Devis Vasquez,2678,co COL,GK,it Serie A,26,1998,32.0,0,0,0,0,0,0,0,,0,0,0,0,0,0,21,4,Devis VasquezEmpoli
Genoa,Johan Vasquez,2679,mx MEX,DF,it Serie A,25,1998,33.8,56,31,24,27,5,26,44,59.1,18,59,31,28,50,106,150,1,Johan VasquezGenoa
Wolfsburg,Denis Vavro,2680,sk SVK,DF,de Bundesliga,28,1996,27.3,21,13,16,5,0,11,23,47.8,12,48,32,16,37,58,234,3,Denis VavroWolfsburg
Valencia,Jose Luis Garcia Vaya,2681,es ESP,MF,es La Liga,25,1998,19.4,43,25,24,13,6,19,33,57.6,14,23,6,17,19,62,42,0,Jose Luis Garcia VayaValencia
Marseille,Robinio Vaz,2682,fr FRA,FW,fr Ligue 1,17,2007,0.8,1,1,0,0,1,0,2,0.0,2,0,0,0,0,1,2,0,Robinio VazMarseille
Valencia,Jesus Vazquez,2683,es ESP,DF,es La Liga,21,2003,10.2,23,18,12,9,2,10,19,52.6,9,16,5,11,10,33,30,0,Jesus VazquezValencia
Real Madrid,Lucas Vazquez,2684,es ESP,DF,es La Liga,33,1991,24.3,58,34,33,17,8,27,48,56.3,21,24,6,18,17,75,35,1,Lucas VazquezReal Madrid
Lazio,Matias Vecino,2685,uy URU,MF,it Serie A,32,1991,9.7,13,7,3,9,1,4,18,22.2,14,9,3,6,5,18,15,0,Matias VecinoLazio
Lecce,Danilo Veiga,2686,pt POR,DF,it Serie A,21,2002,4.2,8,6,4,4,0,6,13,46.2,7,5,0,5,4,12,14,0,Danilo VeigaLecce
Chelsea,Renato Veiga,2687,pt POR,"DF,MF",eng Premier League,21,2003,2.0,9,6,6,3,0,4,12,33.3,8,3,1,2,1,10,2,0,Renato VeigaChelsea
Juventus,Renato Veiga,2688,pt POR,DF,it Serie A,21,2003,12.1,17,12,7,9,1,9,14,64.3,5,17,13,4,19,36,81,0,Renato VeigaJuventus
Espanyol,Alejo Veliz,2689,ar ARG,FW,es La Liga,20,2003,12.5,1,1,0,1,0,1,7,14.3,6,12,2,10,4,5,23,1,Alejo VelizEspanyol
Werder Bremen,Milos Veljkovic,2690,rs SRB,DF,de Bundesliga,28,1995,11.4,10,5,6,3,1,7,15,46.7,8,14,9,5,2,12,47,1,Milos VeljkovicWerder Bremen
Brighton,Joel Veltman,2691,nl NED,DF,eng Premier League,32,1992,18.9,43,29,24,16,3,31,52,59.6,21,22,7,15,19,62,66,0,Joel VeltmanBrighton
Tottenham,Micky van de Ven,2692,nl NED,DF,eng Premier League,23,2001,11.3,10,6,5,4,1,8,14,57.1,6,12,8,4,10,20,39,1,Micky van de VenTottenham
Genoa,Lorenzo Venturino,2693,it ITA,"FW,MF",it Serie A,18,2006,1.9,5,3,4,0,1,3,6,50.0,3,3,0,3,0,5,5,0,Lorenzo VenturinoGenoa
Mainz 05,Nikolas Veratschnig,2694,at AUT,"DF,MF",de Bundesliga,21,2003,4.0,9,6,1,4,4,2,3,66.7,1,4,0,4,5,14,8,0,Nikolas VeratschnigMainz 05
Brighton,Bart Verbruggen,2695,nl NED,GK,eng Premier League,21,2002,36.0,0,0,0,0,0,0,3,0.0,3,1,0,1,0,0,29,5,Bart VerbruggenBrighton
Como,Simone Verdi,2696,it ITA,"MF,FW",it Serie A,32,1992,1.3,2,2,0,1,1,0,2,0.0,2,2,0,2,0,2,2,0,Simone VerdiComo
Lyon,Jordan Veretout,2697,fr FRA,MF,fr Ligue 1,31,1993,17.3,30,14,14,14,2,17,40,42.5,23,17,3,14,5,35,23,1,Jordan VeretoutLyon
RB Leipzig,Arthur Vermeeren,2698,be BEL,MF,de Bundesliga,19,2005,17.5,32,19,14,13,5,14,47,29.8,33,34,12,22,23,55,25,2,Arthur VermeerenRB Leipzig
Union Berlin,Yorbe Vertessen,2699,be BEL,"MF,FW",de Bundesliga,23,2001,8.0,6,3,3,2,1,2,8,25.0,6,6,0,6,3,9,6,0,Yorbe VertessenUnion Berlin
Athletic Club,Mikel Vesga,2700,es ESP,MF,es La Liga,31,1993,11.0,22,15,7,13,2,12,28,42.9,16,10,1,9,15,37,26,0,Mikel VesgaAthletic Club
Leicester City,Jannik Vestergaard,2701,dk DEN,DF,eng Premier League,31,1992,15.5,22,10,16,6,0,9,15,60.0,6,21,14,7,16,38,74,1,Jannik VestergaardLeicester City
Auxerre,Ben Viadere,2702,fr FRA,MF,fr Ligue 1,18,2005,0.1,0,0,0,0,0,0,0,,0,0,0,0,0,0,0,0,Ben ViadereAuxerre
Tottenham,Guglielmo Vicario,2703,it ITA,GK,eng Premier League,27,1996,24.0,0,0,0,0,0,0,0,,0,0,0,0,1,1,14,6,Guglielmo VicarioTottenham
Alaves,Carlos Vicente,2704,es ESP,"FW,MF",es La Liga,25,1999,34.4,47,31,26,11,10,25,64,39.1,39,34,2,32,14,61,40,0,Carlos VicenteAlaves
Barcelona,Pau Victor,2705,es ESP,FW,es La Liga,22,2001,3.5,3,1,0,2,1,0,3,0.0,3,6,1,5,2,5,5,0,Pau VictorBarcelona
Osasuna,Nacho Vidal,2706,es ESP,DF,es La Liga,29,1995,1.4,2,0,0,1,1,1,4,25.0,3,1,0,1,0,2,6,0,Nacho VidalOsasuna
Bayern Munich,Gabriel Vidovic,2707,hr CRO,MF,de Bundesliga,20,2003,0.3,0,0,0,0,0,0,0,,0,2,0,2,0,0,0,0,Gabriel VidovicBayern Munich
Mainz 05,Gabriel Vidovic,2708,hr CRO,MF,de Bundesliga,20,2003,0.0,0,0,0,0,0,0,0,,0,0,0,0,0,0,0,0,Gabriel VidovicMainz 05
Betis,Fran Vieites,2709,es ESP,GK,es La Liga,25,1999,4.0,0,0,0,0,0,0,0,,0,0,0,0,0,0,1,0,Fran VieitesBetis
Las Palmas,Sergio Viera,2710,es ESP,MF,es La Liga,19,2005,1.1,1,1,0,1,0,0,1,0.0,1,1,0,1,1,2,1,0,Sergio VieraLas Palmas
Monza,Samuele Vignato,2711,it ITA,MF,it Serie A,20,2004,5.2,6,3,0,4,2,3,7,42.9,4,1,0,1,0,6,6,0,Samuele VignatoMonza
Alaves,Asier Villalibre,2712,es ESP,FW,es La Liga,26,1997,3.7,2,2,0,1,1,1,2,50.0,1,1,0,1,1,3,7,0,Asier VillalibreAlaves
Celta Vigo,Ivan Villar,2713,es ESP,GK,es La Liga,27,1997,4.0,0,0,0,0,0,0,0,,0,0,0,0,0,0,3,0,Ivan VillarCelta Vigo
Fulham,Carlos Vinicius,2714,br BRA,"MF,FW",eng Premier League,29,1995,0.2,0,0,0,0,0,0,1,0.0,1,1,0,1,0,0,0,0,Carlos ViniciusFulham
Cagliari,Nicolas Viola,2715,it ITA,"FW,MF",it Serie A,34,1989,14.1,14,7,6,7,1,1,10,10.0,9,5,0,5,3,17,5,0,Nicolas ViolaCagliari
Las Palmas,Viti,2716,es ESP,DF,es La Liga,26,1997,22.0,71,46,43,21,7,31,45,68.9,14,28,7,21,27,98,61,0,VitiLas Palmas
Empoli,Mattia Viti,2717,it ITA,DF,it Serie A,22,2002,28.6,65,45,42,20,3,34,52,65.4,18,41,18,23,48,113,128,4,Mattia VitiEmpoli
Genoa,Vitinha,2718,pt POR,"FW,MF",it Serie A,24,2000,14.8,23,8,12,6,5,11,30,36.7,19,14,2,12,12,35,22,0,VitinhaGenoa
Paris S-G,Vitinha,2719,pt POR,MF,fr Ligue 1,24,2000,22.7,43,23,13,27,3,25,48,52.1,23,26,7,19,14,57,19,2,VitinhaParis S-G
Athletic Club,Daniel Vivian,2720,es ESP,DF,es La Liga,25,1999,29.0,40,26,23,14,3,21,32,65.6,11,26,10,16,47,87,152,2,Daniel VivianAthletic Club
Girona,Krapyvtsov Vladyslav,2721,ua UKR,GK,es La Liga,19,2005,2.0,0,0,0,0,0,0,0,,0,0,0,0,0,0,1,1,Krapyvtsov VladyslavGirona
Juventus,Dusan Vlahovic,2722,rs SRB,FW,it Serie A,24,2000,19.8,4,2,0,1,3,1,5,20.0,4,7,3,4,1,5,9,3,Dusan VlahovicJuventus
Atalanta,Vanja Vlahovic,2723,rs SRB,"FW,MF",it Serie A,20,2004,0.7,1,1,0,0,1,0,0,,0,0,0,0,0,1,0,0,Vanja VlahovicAtalanta
Torino,Nikola Vlasic,2724,hr CRO,"MF,FW",it Serie A,26,1997,23.5,37,19,11,17,9,12,30,40.0,18,15,3,12,9,46,15,0,Nikola VlasicTorino
Genoa,Alessandro Vogliacco,2725,it ITA,DF,it Serie A,25,1998,7.9,15,3,7,7,1,10,12,83.3,2,11,7,4,9,24,20,0,Alessandro VogliaccoGenoa
Parma,Alessandro Vogliacco,2726,it ITA,DF,it Serie A,25,1998,8.6,5,2,5,0,0,3,5,60.0,2,15,10,5,3,8,37,0,Alessandro VogliaccoParma
Union Berlin,Kevin Vogt,2727,de GER,DF,de Bundesliga,32,1991,15.2,12,8,7,5,0,8,13,61.5,5,16,8,8,9,21,75,1,Kevin VogtUnion Berlin
Torino,Mergim Vojvoda,2728,xk KVX,DF,it Serie A,29,1995,12.3,18,10,5,9,4,7,14,50.0,7,13,3,10,7,25,24,1,Mergim VojvodaTorino
Como,Mergim Vojvoda,2729,xk KVX,DF,it Serie A,29,1995,8.0,9,6,5,4,0,7,9,77.8,2,7,4,3,3,12,18,0,Mergim VojvodaComo
Union Berlin,Kevin Volland,2730,de GER,"FW,MF",de Bundesliga,32,1992,0.7,0,0,0,0,0,0,0,,0,1,0,1,0,0,1,0,Kevin VollandUnion Berlin
Wolfsburg,Aster Vranckx,2731,be BEL,MF,de Bundesliga,21,2002,6.2,11,6,3,8,0,3,9,33.3,6,14,3,11,10,21,13,0,Aster VranckxWolfsburg
Inter,Stefan de Vrij,2732,nl NED,DF,it Serie A,32,1992,18.2,18,11,12,5,1,9,12,75.0,3,19,11,8,22,40,89,0,Stefan de VrijInter
Saint-Etienne,Ibrahima Wadji,2733,sn SEN,"FW,MF",fr Ligue 1,29,1995,3.9,7,6,3,3,1,3,7,42.9,4,1,0,1,1,8,0,0,Ibrahima WadjiSaint-Etienne
St. Pauli,Robert Wagner,2734,de GER,MF,de Bundesliga,21,2003,4.5,8,3,2,6,0,4,13,30.8,9,8,0,8,2,10,12,0,Robert WagnerSt. Pauli
Marseille,Elye Wahi,2735,fr FRA,FW,fr Ligue 1,21,2003,6.4,0,0,0,0,0,0,4,0.0,4,1,0,1,1,1,0,0,Elye WahiMarseille
Eint Frankfurt,Elye Wahi,2736,fr FRA,"FW,MF",de Bundesliga,21,2003,2.2,0,0,0,0,0,0,1,0.0,1,1,0,1,0,0,1,0,Elye WahiEint Frankfurt
St. Pauli,Hauke Wahl,2737,de GER,DF,de Bundesliga,30,1994,33.0,36,27,21,13,2,23,38,60.5,15,44,25,19,31,67,170,4,Hauke WahlSt. Pauli
Manchester City,Kyle Walker,2738,eng ENG,DF,eng Premier League,34,1990,10.8,17,10,7,7,3,14,26,53.8,12,13,4,9,3,20,13,1,Kyle WalkerManchester City
Milan,Kyle Walker,2739,eng ENG,DF,it Serie A,34,1990,7.3,17,9,12,4,1,13,17,76.5,4,9,5,4,9,26,15,1,Kyle WalkerMilan
Southampton,Kyle Walker-Peters,2740,eng ENG,DF,eng Premier League,27,1997,32.4,44,29,22,15,7,16,35,45.7,19,27,15,12,19,63,90,1,Kyle Walker-PetersSouthampton
Ipswich Town,Christian Walton,2741,eng ENG,GK,eng Premier League,28,1995,7.0,0,0,0,0,0,0,1,0.0,1,0,0,0,0,0,2,1,Christian WaltonIpswich Town
Torino,Sebastian Walukiewicz,2742,pl POL,DF,it Serie A,24,2000,18.5,38,20,18,16,4,23,31,74.2,8,21,8,13,18,56,60,0,Sebastian WalukiewiczTorino
Empoli,Sebastian Walukiewicz,2743,pl POL,DF,it Serie A,24,2000,2.0,1,0,1,0,0,0,1,0.0,1,3,3,0,1,2,15,0,Sebastian WalukiewiczEmpoli
West Ham,Aaron Wan-Bissaka,2744,eng ENG,DF,eng Premier League,26,1997,35.0,70,49,33,32,5,23,32,71.9,9,37,11,26,66,136,125,0,Aaron Wan-BissakaWest Ham
Heidenheim,Paul Wanner,2745,de GER,"MF,FW",de Bundesliga,18,2005,19.7,40,27,16,21,3,15,32,46.9,17,15,0,15,4,44,20,0,Paul WannerHeidenheim
Leicester City,Danny Ward,2746,wls WAL,GK,eng Premier League,31,1993,1.5,0,0,0,0,0,0,0,,0,0,0,0,0,0,1,0,Danny WardLeicester City
Crystal Palace,Joel Ward,2747,eng ENG,DF,eng Premier League,34,1989,0.8,2,0,0,2,0,0,0,,0,0,0,0,0,2,3,0,Joel WardCrystal Palace
West Ham,James Ward-Prowse,2748,eng ENG,MF,eng Premier League,29,1994,11.5,20,14,8,8,4,7,19,36.8,12,6,3,3,8,28,15,0,James Ward-ProwseWest Ham
Nott'ham Forest,James Ward-Prowse,2749,eng ENG,MF,eng Premier League,29,1994,4.4,4,1,1,3,0,2,2,100.0,0,3,2,1,5,9,8,0,James Ward-ProwseNott'ham Forest
Dortmund,Kjell-Arik Watjen,2750,de GER,MF,de Bundesliga,18,2006,0.2,0,0,0,0,0,0,0,,0,0,0,0,0,0,2,0,Kjell-Arik WatjenDortmund
Aston Villa,Ollie Watkins,2751,eng ENG,FW,eng Premier League,28,1995,28.9,10,7,0,6,4,3,11,27.3,8,11,3,8,8,18,15,2,Ollie WatkinsAston Villa
Juventus,Timothy Weah,2752,us USA,"DF,FW",it Serie A,24,2000,18.2,36,19,15,13,8,14,25,56.0,11,25,4,21,14,50,27,2,Timothy WeahJuventus
Brighton,Adam Webster,2753,eng ENG,DF,eng Premier League,29,1995,9.9,10,6,5,4,1,6,14,42.9,8,16,9,7,20,30,41,2,Adam WebsterBrighton
Gladbach,Julian Weigl,2754,de GER,MF,de Bundesliga,28,1995,32.0,53,25,24,24,5,28,46,60.9,18,54,27,27,48,101,86,3,Julian WeiglGladbach
Holstein Kiel,Timon Weiner,2755,de GER,GK,de Bundesliga,25,1999,25.0,0,0,0,0,0,0,1,0.0,1,0,0,0,0,0,17,3,Timon WeinerHolstein Kiel
Mainz 05,Nelson Weiper,2756,de GER,"FW,MF",de Bundesliga,19,2005,7.8,5,4,2,3,0,2,4,50.0,2,5,0,5,2,7,5,1,Nelson WeiperMainz 05
Werder Bremen,Mitchell Weiser,2757,de GER,"DF,MF",de Bundesliga,30,1994,31.9,61,40,19,34,8,28,56,50.0,28,33,3,30,22,83,61,3,Mitchell WeiserWerder Bremen
St. Pauli,Noah Weisshaupt,2758,de GER,"FW,MF",de Bundesliga,22,2001,12.9,6,4,3,0,3,3,8,37.5,5,7,0,7,2,8,8,1,Noah WeisshauptSt. Pauli
Freiburg,Noah Weisshaupt,2759,de GER,FW,de Bundesliga,22,2001,0.9,0,0,0,0,0,0,1,0.0,1,0,0,0,0,0,1,0,Noah WeisshauptFreiburg
Brighton,Danny Welbeck,2760,eng ENG,FW,eng Premier League,33,1990,23.5,26,16,6,15,5,8,20,40.0,12,19,4,15,5,31,14,0,Danny WelbeckBrighton
Southampton,Welington,2761,br BRA,DF,eng Premier League,23,2001,5.4,21,9,15,5,1,12,19,63.2,7,5,1,4,7,28,36,0,WelingtonSouthampton
Tottenham,Timo Werner,2762,de GER,"FW,MF",eng Premier League,28,1996,5.7,6,4,3,3,0,3,13,23.1,10,10,1,9,1,7,7,0,Timo WernerTottenham
Crystal Palace,Adam Wharton,2763,eng ENG,MF,eng Premier League,20,2004,14.6,34,14,14,16,4,17,44,38.6,27,11,2,9,20,54,27,0,Adam WhartonCrystal Palace
Arsenal,Ben White,2764,eng ENG,DF,eng Premier League,26,1997,13.3,20,14,10,4,6,16,38,42.1,22,10,8,2,16,36,44,0,Ben WhiteArsenal
Mainz 05,Silvan Widmer,2765,ch SUI,DF,de Bundesliga,31,1993,5.6,11,5,3,6,2,8,12,66.7,4,7,1,6,5,16,27,0,Silvan WidmerMainz 05
Brighton,Mats Wieffer,2766,nl NED,"DF,MF",eng Premier League,24,1999,11.3,58,34,27,27,4,32,47,68.1,15,18,2,16,17,75,28,3,Mats WiefferBrighton
Cagliari,Mateusz Wieteska,2767,pl POL,DF,it Serie A,27,1997,2.0,1,0,0,1,0,1,1,100.0,0,3,2,1,7,8,6,0,Mateusz WieteskaCagliari
Strasbourg,Caleb Wiley,2768,us USA,"DF,MF",fr Ligue 1,19,2004,3.0,1,0,0,1,0,0,1,0.0,1,3,1,2,4,5,5,0,Caleb WileyStrasbourg
Athletic Club,Inaki Williams,2769,gh GHA,FW,es La Liga,30,1994,29.5,17,10,4,8,5,12,23,52.2,11,34,5,29,12,29,32,0,Inaki WilliamsAthletic Club
Nott'ham Forest,Neco Williams,2770,wls WAL,DF,eng Premier League,23,2001,28.8,90,57,63,19,8,53,86,61.6,33,42,10,32,31,121,137,3,Neco WilliamsNott'ham Forest
Athletic Club,Nico Williams,2771,es ESP,FW,es La Liga,22,2002,22.2,28,18,10,11,7,11,32,34.4,21,20,1,19,7,35,9,0,Nico WilliamsAthletic Club
Fulham,Willian,2772,br BRA,"FW,MF",eng Premier League,35,1988,2.9,4,2,0,3,1,2,6,33.3,4,0,0,0,1,5,1,0,WillianFulham
Newcastle Utd,Joe Willock,2773,eng ENG,"MF,FW",eng Premier League,24,1999,12.1,30,17,15,12,3,18,31,58.1,13,24,6,18,6,36,7,0,Joe WillockNewcastle Utd
Newcastle Utd,Callum Wilson,2774,eng ENG,FW,eng Premier League,32,1992,4.1,2,2,0,1,1,0,2,0.0,2,2,0,2,1,3,1,0,Callum WilsonNewcastle Utd
Fulham,Harry Wilson,2775,wls WAL,"FW,MF",eng Premier League,27,1997,12.9,20,14,13,3,4,12,18,66.7,6,15,1,14,7,27,10,1,Harry WilsonFulham
Wolfsburg,Patrick Wimmer,2776,at AUT,"MF,FW",de Bundesliga,23,2001,19.7,47,35,19,21,7,15,46,32.6,31,31,4,27,32,79,15,2,Patrick WimmerWolfsburg
Wolfsburg,Jonas Wind,2777,dk DEN,"FW,MF",de Bundesliga,25,1999,21.8,10,6,1,8,1,4,8,50.0,4,17,3,14,6,16,15,0,Jonas WindWolfsburg
Leicester City,Harry Winks,2778,eng ENG,MF,eng Premier League,28,1996,17.1,24,11,12,10,2,13,30,43.3,17,19,7,12,9,33,20,0,Harry WinksLeicester City
Bournemouth,Ben Winterburn,2779,eng ENG,"MF,FW",eng Premier League,19,2004,0.3,0,0,0,0,0,0,1,0.0,1,0,0,0,2,2,0,0,Ben WinterburnBournemouth
Leverkusen,Florian Wirtz,2780,de GER,"MF,FW",de Bundesliga,21,2003,26.1,32,20,10,12,10,9,22,40.9,13,32,3,29,10,42,6,1,Florian WirtzLeverkusen
Brentford,Yoane Wissa,2781,cd COD,FW,eng Premier League,27,1996,32.4,22,12,6,8,8,11,27,40.7,16,29,8,21,8,30,21,3,Yoane WissaBrentford
Bochum,Dani de Wit,2782,nl NED,"MF,FW",de Bundesliga,26,1998,12.8,29,17,11,15,3,18,31,58.1,13,17,4,13,12,41,23,1,Dani de WitBochum
Atletico Madrid,Axel Witsel,2783,be BEL,DF,es La Liga,35,1989,9.5,16,12,4,10,2,12,14,85.7,2,15,8,7,11,27,34,1,Axel WitselAtletico Madrid
Bochum,Maximilian Wittek,2784,de GER,DF,de Bundesliga,28,1995,30.1,65,42,40,19,6,38,54,70.4,16,54,8,46,27,92,89,3,Maximilian WittekBochum
Augsburg,Marius Wolf,2785,de GER,DF,de Bundesliga,29,1995,23.8,27,16,13,11,3,16,43,37.2,27,29,5,24,24,51,51,1,Marius WolfAugsburg
Stuttgart,Nick Woltemade,2786,de GER,"FW,MF",de Bundesliga,22,2002,18.0,10,7,2,4,4,6,10,60.0,4,23,2,21,1,11,15,1,Nick WoltemadeStuttgart
Union Berlin,Jeong Woo-yeong,2787,kr KOR,"MF,FW",de Bundesliga,24,1999,14.0,10,7,5,5,0,3,11,27.3,8,10,1,9,11,21,11,0,Jeong Woo-yeongUnion Berlin
Nott'ham Forest,Chris Wood,2788,nz NZL,FW,eng Premier League,32,1991,32.9,6,5,2,2,2,3,11,27.3,8,12,7,5,5,11,29,1,Chris WoodNott'ham Forest
Southampton,Nathan Wood-Gordon,2789,eng ENG,DF,eng Premier League,22,2002,8.6,14,8,8,5,1,8,11,72.7,3,9,6,3,5,19,39,2,Nathan Wood-GordonSouthampton
Rennes,Christopher Wooh,2790,cm CMR,DF,fr Ligue 1,22,2001,16.2,36,19,21,13,2,18,27,66.7,9,22,8,14,23,59,63,0,Christopher WoohRennes
Ipswich Town,Luke Woolfenden,2791,eng ENG,DF,eng Premier League,25,1998,13.2,9,6,5,4,0,2,5,40.0,3,21,14,7,19,28,76,0,Luke WoolfendenIpswich Town
Leverkusen,Granit Xhaka,2792,ch SUI,MF,de Bundesliga,31,1992,32.1,48,26,15,27,6,24,42,57.1,18,30,7,23,12,60,52,6,Granit XhakaLeverkusen
Barcelona,Lamine Yamal,2793,es ESP,FW,es La Liga,17,2007,31.7,42,28,8,17,17,16,38,42.1,22,12,0,12,16,58,3,0,Lamine YamalBarcelona
Real Madrid,Daniel Yanez,2794,es ESP,FW,es La Liga,17,2007,0.0,0,0,0,0,0,0,0,,0,0,0,0,0,0,0,0,Daniel YanezReal Madrid
Hoffenheim,Erencan Yardimci,2795,tr TUR,"FW,MF",de Bundesliga,22,2002,3.5,4,3,1,3,0,1,2,50.0,1,2,0,2,1,5,2,0,Erencan YardimciHoffenheim
Brentford,Yehor Yarmoliuk,2796,ua UKR,MF,eng Premier League,20,2004,16.1,49,28,21,21,7,28,55,50.9,27,26,9,17,13,62,33,0,Yehor YarmoliukBrentford
Nott'ham Forest,Ryan Yates,2797,eng ENG,MF,eng Premier League,26,1997,21.3,42,21,24,14,4,17,37,45.9,20,38,10,28,26,68,61,1,Ryan YatesNott'ham Forest
Venezia,John Yeboah,2798,ec ECU,"FW,MF",it Serie A,24,2000,13.6,6,3,1,3,2,1,10,10.0,9,4,0,4,4,10,2,0,John YeboahVenezia
Getafe,Bertug Yildirim,2799,tr TUR,FW,es La Liga,22,2002,12.0,10,5,0,7,3,2,7,28.6,5,13,2,11,1,11,16,0,Bertug YildirimGetafe
Juventus,Kenan Yildiz,2800,tr TUR,"FW,MF",it Serie A,19,2005,26.7,54,30,13,26,15,18,32,56.3,14,25,0,25,5,59,13,3,Kenan YildizJuventus
Manchester Utd,Leny Yoro,2801,fr FRA,DF,eng Premier League,18,2005,12.9,29,11,19,9,1,13,19,68.4,6,5,3,2,18,47,43,0,Leny YoroManchester Utd
Everton,Ashley Young,2802,eng ENG,DF,eng Premier League,39,1985,20.8,58,33,25,25,8,35,57,61.4,22,14,4,10,25,83,64,2,Ashley YoungEverton
Le Havre,Etienne Youte Kinkoue,2803,fr FRA,DF,fr Ligue 1,22,2002,25.8,19,10,11,7,1,13,20,65.0,7,36,23,13,29,48,158,3,Etienne Youte KinkoueLe Havre
Bournemouth,Illia Zabarnyi,2804,ua UKR,DF,eng Premier League,21,2002,34.5,52,36,31,20,1,34,50,68.0,16,33,20,13,41,93,182,2,Illia ZabarnyiBournemouth
Reims,Eloge Zabi,2805,ci CIV,"DF,MF",fr Ligue 1,17,2006,0.2,0,0,0,0,0,0,0,,0,0,0,0,0,0,1,0,Eloge ZabiReims
Lazio,Mattia Zaccagni,2806,it ITA,FW,it Serie A,29,1995,29.8,38,27,13,21,4,16,32,50.0,16,19,1,18,29,67,22,2,Mattia ZaccagniLazio
Stuttgart,Dan-Axel Zagadou,2807,fr FRA,"DF,MF",de Bundesliga,25,1999,0.3,0,0,0,0,0,0,0,,0,0,0,0,1,1,1,0,Dan-Axel ZagadouStuttgart
Paris S-G,Yoram Zague,2808,fr FRA,"DF,FW",fr Ligue 1,18,2006,2.0,8,6,3,1,4,6,8,75.0,2,3,0,3,2,10,2,0,Yoram ZagueParis S-G
Lyon,Wilfried Zaha,2809,ci CIV,FW,fr Ligue 1,31,1992,0.8,1,1,1,0,0,1,2,50.0,1,3,0,3,1,2,0,0,Wilfried ZahaLyon
Paris S-G,Warren Zaire-Emery,2810,fr FRA,"MF,DF",fr Ligue 1,18,2006,22.8,51,26,17,21,13,23,45,51.1,22,35,6,29,23,74,20,2,Warren Zaire-EmeryParis S-G
Toulouse,Miha Zajc,2811,si SVN,MF,fr Ligue 1,30,1994,2.9,4,4,1,2,1,3,5,60.0,2,2,1,1,3,7,7,0,Miha ZajcToulouse
Monaco,Denis Zakaria,2812,ch SUI,MF,fr Ligue 1,27,1996,23.8,41,26,15,19,7,24,33,72.7,9,31,8,23,34,75,39,1,Denis ZakariaMonaco
Real Sociedad,Arsen Zakharyan,2813,ru RUS,"MF,FW",es La Liga,21,2003,0.8,1,1,1,0,0,1,1,100.0,0,1,1,0,1,2,0,0,Arsen ZakharyanReal Sociedad
Roma,Nicola Zalewski,2814,pl POL,"DF,FW",it Serie A,22,2002,5.9,8,6,3,2,3,2,7,28.6,5,7,2,5,4,12,8,2,Nicola ZalewskiRoma
Inter,Nicola Zalewski,2815,pl POL,"DF,MF",it Serie A,22,2002,4.8,7,4,3,2,2,4,6,66.7,2,5,1,4,2,9,5,1,Nicola ZalewskiInter
Napoli,Andre-Frank Zambo Anguissa,2816,cm CMR,MF,it Serie A,28,1995,31.7,42,26,8,28,6,15,34,44.1,19,24,6,18,35,77,40,1,Andre-Frank Zambo AnguissaNapoli
Venezia,Francesco Zampano,2817,it ITA,DF,it Serie A,30,1993,18.2,31,20,19,10,2,14,31,45.2,17,21,1,20,6,37,29,2,Francesco ZampanoVenezia
Fiorentina,Nicolo Zaniolo,2818,it ITA,FW,it Serie A,25,1999,3.8,3,1,1,2,0,0,4,0.0,4,2,1,1,0,3,2,0,Nicolo ZanioloFiorentina
Atalanta,Nicolo Zaniolo,2819,it ITA,"FW,MF",it Serie A,25,1999,4.0,0,0,0,0,0,0,2,0.0,2,0,0,0,1,1,0,0,Nicolo ZanioloAtalanta
Genoa,Alessandro Zanoli,2820,it ITA,"FW,DF",it Serie A,23,2000,19.0,29,20,11,14,4,10,23,43.5,13,20,3,17,12,41,40,0,Alessandro ZanoliGenoa
Torino,Duvan Zapata,2821,co COL,FW,it Serie A,33,1991,6.5,7,5,2,0,5,0,3,0.0,3,2,1,1,2,9,7,0,Duvan ZapataTorino
Cagliari,Gabriele Zappa,2822,it ITA,DF,it Serie A,24,1999,34.0,40,23,20,17,3,17,34,50.0,17,42,22,20,23,63,93,1,Gabriele ZappaCagliari
Atalanta,Davide Zappacosta,2823,it ITA,DF,it Serie A,32,1992,23.0,26,16,15,5,6,20,39,51.3,19,28,6,22,11,37,32,2,Davide ZappacostaAtalanta
Osasuna,Bryan Zaragoza,2824,es ESP,"FW,MF",es La Liga,23,2001,20.4,13,9,8,4,1,6,21,28.6,15,10,0,10,4,17,8,0,Bryan ZaragozaOsasuna
Lens,Anass Zaroury,2825,ma MAR,"FW,MF",fr Ligue 1,23,2000,15.6,23,17,6,12,5,9,26,34.6,17,9,0,9,6,29,15,0,Anass ZarouryLens
Udinese,Oier Zarraga,2826,es ESP,MF,it Serie A,25,1999,10.0,19,13,7,10,2,10,22,45.5,12,9,5,4,2,21,8,0,Oier ZarragaUdinese
Holstein Kiel,David Zec,2827,si SVN,DF,de Bundesliga,24,2000,17.1,23,10,17,6,0,13,20,65.0,7,32,18,14,17,40,93,3,David ZecHolstein Kiel
Udinese,Jordan Zemura,2828,zw ZIM,DF,it Serie A,24,1999,15.7,31,14,14,12,5,17,29,58.6,12,17,4,13,16,47,41,0,Jordan ZemuraUdinese
Mainz 05,Robin Zentner,2829,de GER,GK,de Bundesliga,29,1994,32.0,2,1,2,0,0,1,2,50.0,1,0,0,0,0,2,31,4,Robin ZentnerMainz 05
Venezia,Alessio Zerbin,2830,it ITA,DF,it Serie A,25,1999,16.9,51,28,30,12,9,29,52,55.8,23,28,3,25,15,66,25,1,Alessio ZerbinVenezia
Napoli,Alessio Zerbin,2831,it ITA,"FW,DF",it Serie A,25,1999,0.0,2,1,2,0,0,1,1,100.0,0,0,0,0,0,2,0,0,Alessio ZerbinNapoli
Monza,Kevin Zeroli,2832,it ITA,MF,it Serie A,19,2005,4.4,6,2,3,3,0,0,1,0.0,1,6,1,5,2,8,11,0,Kevin ZeroliMonza
Milan,Kevin Zeroli,2833,it ITA,MF,it Serie A,19,2005,0.1,1,1,0,1,0,0,0,,0,0,0,0,0,1,0,0,Kevin ZeroliMilan
Augsburg,Cedric Zesiger,2834,ch SUI,DF,de Bundesliga,26,1998,13.6,13,7,7,6,0,8,13,61.5,5,17,10,7,21,34,96,1,Cedric ZesigerAugsburg
Wolfsburg,Cedric Zesiger,2835,ch SUI,DF,de Bundesliga,26,1998,5.8,13,8,6,5,2,6,12,50.0,6,6,5,1,3,16,28,0,Cedric ZesigerWolfsburg
Werder Bremen,Michael Zetterer,2836,de GER,GK,de Bundesliga,29,1995,34.0,0,0,0,0,0,0,1,0.0,1,1,0,1,1,1,10,7,Michael ZettererWerder Bremen
Nantes,Nathan Zeze,2837,fr FRA,DF,fr Ligue 1,19,2005,16.8,38,22,22,16,0,23,33,69.7,10,22,9,13,23,61,120,1,Nathan ZezeNantes
Lille,Edon Zhegrova,2838,xk KVX,"FW,MF",fr Ligue 1,25,1999,10.9,5,2,3,0,2,2,7,28.6,5,8,0,8,4,9,1,0,Edon ZhegrovaLille
Inter,Piotr Zielinski,2839,pl POL,MF,it Serie A,30,1994,10.9,14,10,6,7,1,6,13,46.2,7,10,5,5,6,20,13,1,Piotr ZielinskiInter
Arsenal,Oleksandr Zinchenko,2840,ua UKR,"DF,MF",eng Premier League,27,1996,5.9,6,1,1,3,2,3,8,37.5,5,8,1,7,5,11,10,0,Oleksandr ZinchenkoArsenal
Angers,Melvin Zinga,2841,fr FRA,GK,fr Ligue 1,22,2002,1.0,0,0,0,0,0,0,0,,0,0,0,0,0,0,1,0,Melvin ZingaAngers
Manchester Utd,Joshua Zirkzee,2842,nl NED,"FW,MF",eng Premier League,23,2001,15.6,14,8,3,8,3,5,10,50.0,5,15,4,11,6,20,8,1,Joshua ZirkzeeManchester Utd
Heidenheim,Budu Zivzivadze,2843,ge GEO,FW,de Bundesliga,30,1994,10.6,17,11,1,9,7,4,8,50.0,4,9,0,9,3,20,7,0,Budu ZivzivadzeHeidenheim
Brest,Luck Zogbe,2844,ci CIV,DF,fr Ligue 1,19,2005,7.1,32,18,17,11,4,18,26,69.2,8,11,2,9,14,46,22,1,Luck ZogbeBrest
Cagliari,Nadir Zortea,2845,it ITA,"DF,MF",it Serie A,25,1999,30.1,30,14,16,12,2,14,37,37.8,23,11,0,11,19,49,47,2,Nadir ZorteaCagliari
Auxerre,Aristide Zossou,2846,ci CIV,MF,fr Ligue 1,19,2005,0.2,0,0,0,0,0,0,0,,0,0,0,0,0,0,0,0,Aristide ZossouAuxerre
Le Havre,Yanis Zouaoui,2847,dz ALG,"DF,FW",fr Ligue 1,30,1994,10.8,20,10,10,8,2,11,15,73.3,4,15,2,13,8,28,43,0,Yanis ZouaouiLe Havre
Real Sociedad,Igor Zubeldia,2848,es ESP,DF,es La Liga,27,1997,25.2,34,22,21,10,3,14,26,53.8,12,32,18,14,31,65,100,2,Igor ZubeldiaReal Sociedad
Real Sociedad,Martin Zubimendi,2849,es ESP,MF,es La Liga,25,1999,32.9,73,37,31,29,13,28,44,63.6,16,42,16,26,44,117,79,3,Martin ZubimendiReal Sociedad
Toulouse,Edhy Zuliani,2850,fr FRA,DF,fr Ligue 1,19,2004,0.1,0,0,0,0,0,0,0,,0,0,0,0,1,1,0,0,Edhy ZulianiToulouse
Empoli,Szymon Zurkowski,2851,pl POL,MF,it Serie A,26,1997,1.2,6,4,2,4,0,4,4,100.0,0,3,0,3,1,7,2,0,Szymon ZurkowskiEmpoli
Arsenal,Martin Odegaard,2852,no NOR,MF,eng Premier League,25,1998,25.8,19,11,9,7,3,4,25,16.0,21,5,0,5,6,25,6,1,Martin OdegaardArsenal
Monza,Milan Duric,2853,ba BIH,FW,it Serie A,34,1990,14.1,1,1,0,1,0,0,3,0.0,3,6,0,6,2,3,17,0,Milan DuricMonza
Parma,Milan Duric,2854,ba BIH,FW,it Serie A,34,1990,3.0,0,0,0,0,0,0,2,0.0,2,3,0,3,0,0,2,0,Milan DuricParma
